DATE POSTED,AUTHOR,TITLE,LINK,DAYS SINCE POSTED,LIKES,SHARES,COMMENTS,TOTAL ENGAGEMENT
Jun 8 2014,Erick P. '17,Attended the 148th Commencement,http://mitadmissions.org/blogs/entry/attended-the-148th-commencement,3,1,2,0,3
Jun 8 2014,Anna H. '14,I graduated,http://mitadmissions.org/blogs/entry/well-i-graduated,3,0,1,0,1
Jun 8 2014,Ceri R. '16,Odd Jobs,http://mitadmissions.org/blogs/entry/odd-jobs,3,0,0,0,0
Jun 6 2014,Chris Peterson,Commence the Commencing!,http://mitadmissions.org/blogs/entry/commence-the-commencing,5,0,1,0,1
Jun 5 2014,Anna H. '14,"Post-Finals, Pre-Graduation",http://mitadmissions.org/blogs/entry/post-finals-pre-graduation,6,0,0,0,0
Jun 3 2014,Chris Peterson,So @mitblogs_ebooks exists,http://mitadmissions.org/blogs/entry/how-i-made-mitblogs-ebooks,8,1,1,0,2
Jun 3 2014,Allan K. '17,A Day at Stanford University,http://mitadmissions.org/blogs/entry/a-day-at-stanford-university,8,18,1,2,21
Jun 2 2014,Vincent A. '17,"The Room, A Short Story",http://mitadmissions.org/blogs/entry/the-room-a-short-story,9,0,0,0,0
May 31 2014,Anna H. '14,Leonard Nimoy at the Boston Pops,http://mitadmissions.org/blogs/entry/leonard-nimoy-at-the-boston-pops,11,0,1,0,1
May 30 2014,Kirsten L. '15 ,Thoughts from the Other Side,http://mitadmissions.org/blogs/entry/thoughts-from-the-other-side1,12,27,3,11,41
May 28 2014,Elizabeth C. '13,Life After (and During) MIT,http://mitadmissions.org/blogs/entry/life-after-and-during-mit2,14,14,6,3,23
May 24 2014,Krystal L. '17,The End of an Era,http://mitadmissions.org/blogs/entry/the-end-of-an-era,18,0,0,0,0
May 24 2014,Vincent A. '17,A Chapter Closes,http://mitadmissions.org/blogs/entry/a-chapter-closes,18,0,1,0,1
May 23 2014,Chris Peterson,The Epic Split Feat. Tim Beaver (Live Test 6.28),http://mitadmissions.org/blogs/entry/the-epic-split-feat.-tim-beaver-live-test-6.28,19,0,1,0,1
May 21 2014,Chris Peterson,MITAdmissions.org: Now 100% More Clickable,http://mitadmissions.org/blogs/entry/mitadmissions.org-now-100-more-clickable,21,0,0,0,0
May 19 2014,Rachel D. '16,Finals Week at MIT,http://mitadmissions.org/blogs/entry/finals-week-at-mit1,23,2,2,0,4
May 18 2014,Natnael G. '15,Whats Making Me Happy: Week 3,http://mitadmissions.org/blogs/entry/whats-making-me-happy-week-3,24,0,0,0,0
May 17 2014,Rachel D. '16,Thinking Positive,http://mitadmissions.org/blogs/entry/thinking-positive,25,0,0,0,0
May 16 2014,Anna H. '14,We met an alumnus from the Class of 1952,http://mitadmissions.org/blogs/entry/we-met-an-alumnus-from-the-class-of-1952,26,5,1,1,7
May 16 2014,Ceri R. '16,A Vicious Cycle,http://mitadmissions.org/blogs/entry/a-vicious-cycle,26,10,0,0,10
May 15 2014,Allan K. '17,The First Ending,http://mitadmissions.org/blogs/entry/the-first-ending,27,172,9,7,188
May 15 2014,Chris Peterson,Fall 2014 Wait List Decisions Will Be Sent Today,http://mitadmissions.org/blogs/entry/fall-2014-wait-list-decisions-to-be-announced-later-today,27,0,3,0,3
May 13 2014,Rachel D. '16,Advice for the Incoming Froshies,http://mitadmissions.org/blogs/entry/advice-for-the-incoming-froshies,29,0,12,0,12
May 12 2014,Erick P. '17,MIT: The Sunsical,http://mitadmissions.org/blogs/entry/mit-the-sunsical,30,20,3,2,25
May 9 2014,Michael C. '16,Do You Want To Build a Robot?,http://mitadmissions.org/blogs/entry/do-you-want-to-build-a-robot,33,45,12,7,64
May 9 2014,Natnael G. '15,Whats Making Me Happy: Week 2,http://mitadmissions.org/blogs/entry/whats-making-me-happy-week-2,33,1,1,0,2
May 8 2014,Erick P. '17,Batman Picks a Username,http://mitadmissions.org/blogs/entry/batman-picks-a-username,34,14,3,2,19
May 8 2014,Rachel D. '16,Study Break on the Roof!,http://mitadmissions.org/blogs/entry/study-break-on-the-roof,34,0,2,0,2
May 7 2014,Chris Peterson,Fall 2014 Transfer Decisions Will Be Sent Today,http://mitadmissions.org/blogs/entry/fall-2014-transfer-decisions-will-be-sent-today,35,1,0,0,1
May 5 2014,Anna H. '14,"Advocating for Science on Capitol Hill, Part 2",http://mitadmissions.org/blogs/entry/advocating-for-science-on-capitol-hill-part-2,37,3,2,0,5
May 4 2014,Anastassia B. '16,Happenings,http://mitadmissions.org/blogs/entry/happenings,38,48,2,4,54
May 3 2014,Rachel D. '16,A Faculty Dinner,http://mitadmissions.org/blogs/entry/a-faculty-dinner,39,11,2,0,13
May 3 2014,Ceri R. '16,Gettin Fancy,http://mitadmissions.org/blogs/entry/gettin-fancy1,39,6,1,0,7
May 2 2014,Natnael G. '15,Whats Making Me Happy This Week: Week 1,http://mitadmissions.org/blogs/entry/things-that-are-making-me-happy-week-1,40,2,1,0,3
May 2 2014,Mikey Yang '05,Its May 2nd. Have you replied to your colleges yet?,http://mitadmissions.org/blogs/entry/its-may-2nd.-have-you-replied-to-your-colleges-yet,40,0,0,0,0
May 1 2014,Latasha Boyd,A Time to Enroll,http://mitadmissions.org/blogs/entry/a-time-to-enroll,41,0,0,0,0
May 1 2014,Krystal L. '17,Theres No I in Team,http://mitadmissions.org/blogs/entry/theres-no-i-in-team,41,15,1,0,16
Apr 30 2014,Anna H. '14,Books write our life stories,http://mitadmissions.org/blogs/entry/books-write-our-life-stories,42,5,2,2,9
Apr 27 2014,Rachel D. '16,SpringFest 2014!,http://mitadmissions.org/blogs/entry/springfest-2014,45,0,1,0,1
Apr 25 2014,Rachel D. '16,Class of 2016 Ring Delivery!,http://mitadmissions.org/blogs/entry/class-of-2016-ring-delivery,47,10,4,0,14
