DATE POSTED,AUTHOR,TITLE,LINK,DAYS SINCE POSTED,LIKES,SHARES,COMMENTS,TOTAL ENGAGEMENT
Jun 8 2014,Erick P. '17,Attended the 148th Commencement,http://mitadmissions.org/blogs/entry/attended-the-148th-commencement,4,1,2,0,3
Jun 8 2014,Anna H. '14,I graduated,http://mitadmissions.org/blogs/entry/well-i-graduated,4,0,1,0,1
Jun 8 2014,Ceri R. '16,Odd Jobs,http://mitadmissions.org/blogs/entry/odd-jobs,4,0,0,0,0
Jun 6 2014,Chris Peterson,Commence the Commencing!,http://mitadmissions.org/blogs/entry/commence-the-commencing,6,0,1,0,1
Jun 5 2014,Anna H. '14,"Post-Finals, Pre-Graduation",http://mitadmissions.org/blogs/entry/post-finals-pre-graduation,7,0,0,0,0
Jun 3 2014,Chris Peterson,So @mitblogs_ebooks exists,http://mitadmissions.org/blogs/entry/how-i-made-mitblogs-ebooks,9,1,1,0,2
Jun 3 2014,Allan K. '17,A Day at Stanford University,http://mitadmissions.org/blogs/entry/a-day-at-stanford-university,9,18,1,2,21
Jun 2 2014,Vincent A. '17,"The Room, A Short Story",http://mitadmissions.org/blogs/entry/the-room-a-short-story,10,0,0,0,0
May 31 2014,Anna H. '14,Leonard Nimoy at the Boston Pops,http://mitadmissions.org/blogs/entry/leonard-nimoy-at-the-boston-pops,12,0,1,0,1
May 30 2014,Kirsten L. '15 ,Thoughts from the Other Side,http://mitadmissions.org/blogs/entry/thoughts-from-the-other-side1,13,27,3,11,41
May 28 2014,Elizabeth C. '13,Life After (and During) MIT,http://mitadmissions.org/blogs/entry/life-after-and-during-mit2,15,14,6,3,23
May 24 2014,Krystal L. '17,The End of an Era,http://mitadmissions.org/blogs/entry/the-end-of-an-era,19,0,0,0,0
May 24 2014,Vincent A. '17,A Chapter Closes,http://mitadmissions.org/blogs/entry/a-chapter-closes,19,0,1,0,1
May 23 2014,Chris Peterson,The Epic Split Feat. Tim Beaver (Live Test 6.28),http://mitadmissions.org/blogs/entry/the-epic-split-feat.-tim-beaver-live-test-6.28,20,0,1,0,1
May 21 2014,Chris Peterson,MITAdmissions.org: Now 100% More Clickable,http://mitadmissions.org/blogs/entry/mitadmissions.org-now-100-more-clickable,22,0,0,0,0
May 19 2014,Rachel D. '16,Finals Week at MIT,http://mitadmissions.org/blogs/entry/finals-week-at-mit1,24,2,2,0,4
May 18 2014,Natnael G. '15,Whats Making Me Happy: Week 3,http://mitadmissions.org/blogs/entry/whats-making-me-happy-week-3,25,0,0,0,0
May 17 2014,Rachel D. '16,Thinking Positive,http://mitadmissions.org/blogs/entry/thinking-positive,26,0,0,0,0
May 16 2014,Anna H. '14,We met an alumnus from the Class of 1952,http://mitadmissions.org/blogs/entry/we-met-an-alumnus-from-the-class-of-1952,27,5,1,1,7
May 16 2014,Ceri R. '16,A Vicious Cycle,http://mitadmissions.org/blogs/entry/a-vicious-cycle,27,10,0,0,10
May 15 2014,Allan K. '17,The First Ending,http://mitadmissions.org/blogs/entry/the-first-ending,28,172,9,7,188
May 15 2014,Chris Peterson,Fall 2014 Wait List Decisions Will Be Sent Today,http://mitadmissions.org/blogs/entry/fall-2014-wait-list-decisions-to-be-announced-later-today,28,0,3,0,3
May 13 2014,Rachel D. '16,Advice for the Incoming Froshies,http://mitadmissions.org/blogs/entry/advice-for-the-incoming-froshies,30,0,12,0,12
May 12 2014,Erick P. '17,MIT: The Sunsical,http://mitadmissions.org/blogs/entry/mit-the-sunsical,31,20,3,2,25
May 9 2014,Michael C. '16,Do You Want To Build a Robot?,http://mitadmissions.org/blogs/entry/do-you-want-to-build-a-robot,34,45,12,7,64
May 9 2014,Natnael G. '15,Whats Making Me Happy: Week 2,http://mitadmissions.org/blogs/entry/whats-making-me-happy-week-2,34,1,1,0,2
May 8 2014,Erick P. '17,Batman Picks a Username,http://mitadmissions.org/blogs/entry/batman-picks-a-username,35,14,3,2,19
May 8 2014,Rachel D. '16,Study Break on the Roof!,http://mitadmissions.org/blogs/entry/study-break-on-the-roof,35,0,2,0,2
May 7 2014,Chris Peterson,Fall 2014 Transfer Decisions Will Be Sent Today,http://mitadmissions.org/blogs/entry/fall-2014-transfer-decisions-will-be-sent-today,36,1,0,0,1
May 5 2014,Anna H. '14,"Advocating for Science on Capitol Hill, Part 2",http://mitadmissions.org/blogs/entry/advocating-for-science-on-capitol-hill-part-2,38,3,2,0,5
May 4 2014,Anastassia B. '16,Happenings,http://mitadmissions.org/blogs/entry/happenings,39,48,2,4,54
May 3 2014,Rachel D. '16,A Faculty Dinner,http://mitadmissions.org/blogs/entry/a-faculty-dinner,40,11,2,0,13
May 3 2014,Ceri R. '16,Gettin Fancy,http://mitadmissions.org/blogs/entry/gettin-fancy1,40,6,1,0,7
May 2 2014,Natnael G. '15,Whats Making Me Happy This Week: Week 1,http://mitadmissions.org/blogs/entry/things-that-are-making-me-happy-week-1,41,2,1,0,3
May 2 2014,Mikey Yang '05,Its May 2nd. Have you replied to your colleges yet?,http://mitadmissions.org/blogs/entry/its-may-2nd.-have-you-replied-to-your-colleges-yet,41,0,0,0,0
May 1 2014,Latasha Boyd,A Time to Enroll,http://mitadmissions.org/blogs/entry/a-time-to-enroll,42,0,0,0,0
May 1 2014,Krystal L. '17,Theres No I in Team,http://mitadmissions.org/blogs/entry/theres-no-i-in-team,42,15,1,0,16
Apr 30 2014,Anna H. '14,Books write our life stories,http://mitadmissions.org/blogs/entry/books-write-our-life-stories,43,5,2,2,9
Apr 27 2014,Rachel D. '16,SpringFest 2014!,http://mitadmissions.org/blogs/entry/springfest-2014,46,0,1,0,1
Apr 25 2014,Rachel D. '16,Class of 2016 Ring Delivery!,http://mitadmissions.org/blogs/entry/class-of-2016-ring-delivery,48,10,4,0,14
Apr 25 2014,Allan K. '17,Have you ever wanted to copy-paste the text in an image file?,http://mitadmissions.org/blogs/entry/have-you-ever-wanted-to-copy-paste-the-text-in-an-image-file,48,24,3,3,30
Apr 24 2014,Anna H. '14,"Advocating for Science on Capitol Hill, Part 1",http://mitadmissions.org/blogs/entry/science-advocacy-on-capitol-hill-preparing,49,2,2,0,4
Apr 24 2014,Vincent A. '17,"An Evening With Pizza, Constipation and Hell-Sucked Villains",http://mitadmissions.org/blogs/entry/an-evening-with-pizza-constipation-and-hell-sucked-villains2,49,4,2,0,6
Apr 22 2014,Rachel D. '16,Adventure Time at MIT,http://mitadmissions.org/blogs/entry/adventure-time-at-mit,51,0,3,0,3
Apr 21 2014,Erick P. '17,What if You Didnt Like CPW?,http://mitadmissions.org/blogs/entry/what-if-you-didnt-like-cpw,52,29,6,5,40
Apr 20 2014,Lydia K. '14,AMA,http://mitadmissions.org/blogs/entry/ama,53,15,2,3,20
Apr 15 2014,Anna H. '14,Dudamel,http://mitadmissions.org/blogs/entry/dudamel1,58,3,0,0,3
Apr 15 2014,Allan K. '17,Blown Back to Oz,http://mitadmissions.org/blogs/entry/blown-back-to-oz,58,6,2,10,18
Apr 13 2014,Anna H. '14,Teaching Abroad: a Guest Blog Post by Elizabeth Q. 14,http://mitadmissions.org/blogs/entry/teaching-abroad-a-guest-blog-post-by-elizabeth-q.-14,60,5,2,3,10
Apr 12 2014,Allan K. '17,We Are All Slaves to the Wind,http://mitadmissions.org/blogs/entry/we-are-all-slaves-to-the-wind,61,0,0,0,0
Apr 12 2014,Rachel D. '16,CPW Update - Featuring Tim the Beaver as Miley Cyrus,http://mitadmissions.org/blogs/entry/cpw-update-featuring-tim-the-beaver-as-miley-cyrus1,61,65,17,14,96
Apr 11 2014,Allan K. '17,No Touching,http://mitadmissions.org/blogs/entry/no-touching,62,4,1,0,5
Apr 10 2014,Allan K. '17,Not in Kansas Anymore,http://mitadmissions.org/blogs/entry/not-in-kansas-anymore-dbf,63,6,2,4,12
Apr 10 2014,Krystal L. '17,"Events, Food, and Awesomeness: CPW",http://mitadmissions.org/blogs/entry/events-food-and-awesomeness-cpw,63,0,0,0,0
Apr 10 2014,Vincent A. '17,CPW at Random Hall!,http://mitadmissions.org/blogs/entry/cpw-in-random-hall,63,3,3,0,6
Apr 9 2014,Rachel D. '16,CPW Q&A,http://mitadmissions.org/blogs/entry/cpwqa,64,3,3,0,6
Apr 9 2014,Connie H. '15,Spot the Blogger,http://mitadmissions.org/blogs/entry/spot-the-blogger,64,1,3,0,4
Apr 9 2014,Kim Hunter '86,CPW 2014The Parent Edition,http://mitadmissions.org/blogs/entry/cpw-2014...the-parent-editio,64,1,0,0,1
Apr 9 2014,Erick P. '17,Admitted Student Gathering,http://mitadmissions.org/blogs/entry/admitted-student-gathering,64,26,5,3,34
Apr 8 2014,Natnael G. '15,Studying At Cambridge 101,http://mitadmissions.org/blogs/entry/studying-101,65,11,1,1,13
Apr 7 2014,Mikey Yang '05,Wait List Confirmation Form,http://mitadmissions.org/blogs/entry/wait-list-confirmation-form,66,0,0,0,0
Apr 6 2014,Rachel D. '16,How I Spent My Sophomore Spring Break,http://mitadmissions.org/blogs/entry/how-i-spent-my-sophomore-spring-break,67,2,1,1,4
Apr 1 2014,Vincent A. '17,My Final Blogpost,http://mitadmissions.org/blogs/entry/my-final-blogpost,72,7,1,0,8
Apr 1 2014,Natnael G. '15,The Seven Supervisors,http://mitadmissions.org/blogs/entry/the-seven-supervisors,72,1,1,0,2
Mar 31 2014,Kirsten L. '15 ,The Other Side,http://mitadmissions.org/blogs/entry/the-other-side,73,43,1,8,52
Mar 28 2014,Anna H. '14,Climb Every Mountain: a Guest Blog Post by Davie R. 12,http://mitadmissions.org/blogs/entry/climb-every-mountain,76,3,2,4,9
Mar 25 2014,Connie H. '15,The First Time I Underpacked,http://mitadmissions.org/blogs/entry/the-first-time-i-underpacked1,79,1,1,0,2
Mar 22 2014,Allan K. '17,Out There,http://mitadmissions.org/blogs/entry/out-there,82,3,1,0,4
Mar 21 2014,Lydia K. '14,"Two households, totally unalike in dignity",http://mitadmissions.org/blogs/entry/rtweetsj,83,19,7,4,30
Mar 20 2014,Kim Hunter '86,Class of 2018 Spring Welcome Events Come to Your Area,http://mitadmissions.org/blogs/entry/class-of-2018-spring-welcome-events-come-to-your-area,84,2,3,0,5
Mar 17 2014,Anna H. '14,SCIENCE ALERT: smoking gun evidence for Alan Guths theory of inflation!,http://mitadmissions.org/blogs/entry/science-alert-smoking-gun-evidence-for-inflation,87,32,4,6,42
Mar 15 2014,Kris Guay,FAQ: Waitlist,http://mitadmissions.org/blogs/entry/faq-waitlist1,89,1,0,0,1
Mar 14 2014,Chris Peterson,MIT Regular Action Decisions Now Available Online,http://mitadmissions.org/blogs/entry/mit-regular-action-decisions-now-available-online1,90,10,2,0,12
Mar 14 2014,Decisions,Open Thread: Admitted!,http://mitadmissions.org/blogs/entry/open-thread-admitted3,90,1,3,0,4
Mar 14 2014,Decisions,Open Thread: Waitlisted,http://mitadmissions.org/blogs/entry/open-thread-waitlisted2,90,0,0,0,0
Mar 14 2014,Decisions,Open Thread: Not Admitted,http://mitadmissions.org/blogs/entry/open-thread-not-admitted2,90,4,0,0,4
Mar 13 2014,Erick P. '17,My Two Cents,http://mitadmissions.org/blogs/entry/my-two-cents,91,82,11,0,93
Mar 13 2014,Ceri R. '16,Just Desserts,http://mitadmissions.org/blogs/entry/just-desserts,91,3,1,0,4
Mar 13 2014,Latasha Boyd,Believe in your magic,http://mitadmissions.org/blogs/entry/believe-in-your-magic,91,91,16,19,126
Mar 12 2014,Vincent A. '17,Why I Took A Gap Year,http://mitadmissions.org/blogs/entry/why-i-took-a-gap-year,92,149,27,15,191
Mar 11 2014,Anastassia B. '16,10 Lessons,http://mitadmissions.org/blogs/entry/10-lessons,93,27,2,3,32
Mar 11 2014,Krystal L. '17,Selling Point,http://mitadmissions.org/blogs/entry/selling-point,93,2,4,1,7
Mar 10 2014,Allan K. '17,Preparing for Pi Day,http://mitadmissions.org/blogs/entry/preparing-for-pi-day,94,2,2,0,4
Mar 10 2014,Rachel F. '12,Pi(e) Day: The Baking Of,http://mitadmissions.org/blogs/entry/pie-day-the-baking-of,94,1,0,0,1
Mar 7 2014,Anna H. '14,Hello! I would like to schedule a meeting with Senator Markey.,http://mitadmissions.org/blogs/entry/hello-i-would-like-to-schedule-a-meeting-with-senator,97,2,0,0,2
Mar 7 2014,Rachel D. '16,My First Week as an EMT,http://mitadmissions.org/blogs/entry/my-first-week-as-an-emt,97,1,1,0,2
Mar 6 2014,Natasha B. '16,"DarkMatters, Green and Wild, Chocolate Cake and Raspberries",http://mitadmissions.org/blogs/entry/darkmatters-green-and-wild-chocolate-cake-and-raspberries,98,0,0,0,0
Mar 6 2014,A Delicious Pie,There Will Be Pi (Day),http://mitadmissions.org/blogs/entry/there-will-be-pi-day,98,10,18,3,31
Mar 3 2014,Ana V. '15 ,Latino Cultural Center,http://mitadmissions.org/blogs/entry/centro-cultural-latino,101,63,8,1,72
Feb 27 2014,Anna H. '14,Astronomy in Paradise Lost,http://mitadmissions.org/blogs/entry/astronomy-in-paradise-lost,105,3,1,0,4
Feb 26 2014,Allan K. '17,A Hacking Story,http://mitadmissions.org/blogs/entry/a-hacking-story,106,0,0,0,0
Feb 25 2014,Rachel D. '16,Another New Semester and A Lot of Cats,http://mitadmissions.org/blogs/entry/another-new-semester-and-a-lot-of-cats,107,3,2,0,5
Feb 25 2014,Lydia K. '14,My Desk and the Things That Live There,http://mitadmissions.org/blogs/entry/my-desk,107,4,1,0,5
Feb 25 2014,Natasha B. '16,January in the Studio,http://mitadmissions.org/blogs/entry/january-in-the-studio,107,0,1,0,1
Feb 25 2014,Vincent A. '17,The Punt Puzzle,http://mitadmissions.org/blogs/entry/the-punt-puzzle,107,1,3,0,4
Feb 25 2014,Vincent A. '17,Its been 3 weeks,http://mitadmissions.org/blogs/entry/its-been-3-weeks,107,2,1,0,3
Feb 17 2014,Anna H. '14,2 Classes For 0 Credit: Beethoven to Mahler and Paradise Lost,http://mitadmissions.org/blogs/entry/2-classes-for-0-credit,115,1,0,0,1
Feb 16 2014,Connie H. '15,The Polar Vortex,http://mitadmissions.org/blogs/entry/polar-vortex,116,1,3,0,4
Feb 14 2014,Lydia K. '14,Dragons,http://mitadmissions.org/blogs/entry/dragons,118,50,25,14,89
Feb 13 2014,Erick P. '17,MIT: The Snowsical,http://mitadmissions.org/blogs/entry/mit-the-snowsical,119,27,5,4,36
Feb 9 2014,Anastassia B. '16,An Olympic Hack,http://mitadmissions.org/blogs/entry/an-olympic-hack,123,47,19,24,90
Feb 9 2014,Krystal L. '17,Ushering in a New Era,http://mitadmissions.org/blogs/entry/ushering-in-a-new-era,123,0,0,0,0
Feb 9 2014,Anna H. '14,Hwt! Did you know that you can study Old English at MIT?,http://mitadmissions.org/blogs/entry/studying-old-english-at-mit,123,0,1,0,1
Feb 8 2014,Michael C. '16,Brass Rat 2016,http://mitadmissions.org/blogs/entry/brass-rat-2016,124,101,21,14,136
Feb 6 2014,Natnael G. '15,Moving Across The Pond,http://mitadmissions.org/blogs/entry/moving-across-the-pond,126,8,5,1,14
Feb 5 2014,Chris Peterson,About That Email,http://mitadmissions.org/blogs/entry/about-that-email,127,27,28,15,70
Feb 4 2014,Anna H. '14,"Day 2: Hiking up a volcano at 15,000 ft (~4.5 km)",http://mitadmissions.org/blogs/entry/day-2-hiking-up-a-volcano-at-15000-ft-4.5-km,128,2,0,0,2
Feb 4 2014,Anna H. '14,Day 1: Quito Old Town,http://mitadmissions.org/blogs/entry/day-1-quito-old-town,128,26,1,0,27
Feb 4 2014,Anna H. '14,Day 0: from DC to Quito,http://mitadmissions.org/blogs/entry/day-0-from-dc-to-quito,128,1,0,0,1
Feb 4 2014,Anna H. '14,The Abstract,http://mitadmissions.org/blogs/entry/the-abstract,128,0,0,0,0
Feb 4 2014,Kris Guay,Important Information about your Financial Aid Application,http://mitadmissions.org/blogs/entry/important-info-about-your-financial-aid-application,128,0,0,0,0
Feb 3 2014,Michael C. '16,#funhogging,http://mitadmissions.org/blogs/entry/funhogging,129,11,3,0,14
Jan 31 2014,Stanley G.,Day 1: Going North,http://mitadmissions.org/blogs/entry/day-1-going-north,132,0,0,0,0
Jan 26 2014,Rachel D. '16,Different Perspectives,http://mitadmissions.org/blogs/entry/different-perspectives,137,18,3,1,22
Jan 25 2014,Ceri R. '16,,http://mitadmissions.org/blogs/entry/wholock,138,0,3,5,8
Jan 24 2014,Ceri R. '16,Actividades Independientes,http://mitadmissions.org/blogs/entry/actividades-independientes,139,0,1,0,1
Jan 24 2014,Vincent A. '17,O bu nkita nime ulo akukwo?,http://mitadmissions.org/blogs/entry/o-bu-nkita-nime-ulo-akukwo,139,0,0,0,0
Jan 23 2014,Snively '11,flag flag flag flag flag,http://mitadmissions.org/blogs/entry/flag-flag-flag-flag-flag,140,0,1,0,1
Jan 23 2014,Erick P. '17,0110100001101001,http://mitadmissions.org/blogs/entry/zero-zero-one-one-one-one-one-one,140,10,6,11,27
Jan 22 2014,Chris S. '11,,http://mitadmissions.org/blogs/entry/lets-cook,141,2,4,0,6
Jan 22 2014,Piper '13,-.... - . .-. -./ .... ..- -. -!,http://mitadmissions.org/blogs/entry/winning-mystery-hunt,141,0,0,0,0
Jan 21 2014,Allan K. '17,Une exprimentation de lindpendance: partie la troisime,http://mitadmissions.org/blogs/entry/une-experimentation-de-lindependance-partie-la-troisieme,142,0,0,0,0
Jan 21 2014,Anastassia B. '16, !,http://mitadmissions.org/blogs/entry/whoa,142,14,3,0,17
Jan 21 2014,Ceri R. '16,,http://mitadmissions.org/blogs/entry/an-ode,142,1,0,0,1
Jan 21 2014,Emad T. '14,Est-ce que je suis prt? Peut-tre.,http://mitadmissions.org/blogs/entry/est-ce-que-je-suis-pret-peut-etre,142,0,0,0,0
Jan 21 2014,Krystal L. '17,Hola. No Hablo Espaol.,http://mitadmissions.org/blogs/entry/hola.-no-hablo-espanol,142,1,2,0,3
Jan 20 2014,Vincent A. '17,")!
        ",http://mitadmissions.org/blogs/entry/v9w,143,10,2,1,13
Jan 20 2014,Chris S. '11,,http://mitadmissions.org/blogs/entry/new-york-and-me,143,1,0,0,1
Jan 19 2014,Snively '11,Uba Quubick Hubellubo,http://mitadmissions.org/blogs/entry/a-quick-hello,144,11,4,3,18
Jan 18 2014,Kris Guay,Missing Documents Deadline,http://mitadmissions.org/blogs/entry/missing-documents-deadline3,145,0,0,0,0
Jan 17 2014,Allan K. '17,An Experiment in Independence: PART TWO.,http://mitadmissions.org/blogs/entry/an-experiment-in-independence-part-two,146,27,3,3,33
Jan 17 2014,Michael C. '16,I walked on water*,http://mitadmissions.org/blogs/entry/i-walked-on-water,146,23,5,1,29
Jan 17 2014,Connie H. '15,The Semester in Photos,http://mitadmissions.org/blogs/entry/the-semester-in-photos,146,0,0,0,0
Jan 16 2014,Erick P. '17,Go Read Some Science Fiction,http://mitadmissions.org/blogs/entry/go-read-some-science-fiction,147,15,9,0,24
Jan 13 2014,Natasha B. '16,Poetry Prescriptions,http://mitadmissions.org/blogs/entry/salty-oats-and-poetry-prescribed,150,15,3,0,18
Jan 13 2014,Kris Guay,Your February Notes and Updates Form,http://mitadmissions.org/blogs/entry/your-february-notes-and-updates-form,150,6,5,0,11
Jan 12 2014,Rachel D. '16,Sophomore Slump,http://mitadmissions.org/blogs/entry/sophomore-slump1,151,0,2,0,2
Jan 9 2014,Anna H. '14,Meeting Neil deGrasse Tyson,http://mitadmissions.org/blogs/entry/meeting-neil-degrasse-tyson,154,105,93,44,242
Jan 6 2014,Ceri R. '16,Going Home,http://mitadmissions.org/blogs/entry/going-home,157,3,1,0,4
Jan 5 2014,Allan K. '17,An Experiment in Independence,http://mitadmissions.org/blogs/entry/an-experiment-in-independence,158,0,0,0,0
Jan 3 2014,Anna H. '14,Mormons and video gamers,http://mitadmissions.org/blogs/entry/mormons-and-video-gamers,160,3,3,1,7
Jan 2 2014,Erick P. '17,2014 Resolutions,http://mitadmissions.org/blogs/entry/2014-resolutions,161,11,2,1,14
Jan 1 2014,Vincent A. '17,Its 2014!,http://mitadmissions.org/blogs/entry/its-2014,162,3,1,0,4
Dec 30 2013,Erick P. '17,Happy Holidays,http://mitadmissions.org/blogs/entry/happy-holidays,164,38,6,1,45
Dec 29 2013,Vincent A. '17,Twas a good semester twas,http://mitadmissions.org/blogs/entry/twas-a-good-semester-tw,165,9,0,0,9
Dec 27 2013,Anna H. '14,"Mustaches in the airport, Daleks in the library, and Food in many stomachs",http://mitadmissions.org/blogs/entry/mustaches-in-the-airport,167,39,4,0,43
Dec 23 2013,Michael C. '16,What Should I Bring To College? (partly) answered,http://mitadmissions.org/blogs/entry/what-should-i-bring-to-college-partly-answered,171,45,5,12,62
Dec 23 2013,Anna H. '14,Physics professors have a charming sense of humour,http://mitadmissions.org/blogs/entry/physics-professors-have-a-charming-sense-of-humour,171,127,31,9,167
Dec 22 2013,Anna H. '14,The Swim Test Saga,http://mitadmissions.org/blogs/entry/the-swim-test-saga1,172,39,11,5,55
Dec 21 2013,Allan K. '17,Being Home and Answering Questions,http://mitadmissions.org/blogs/entry/being-home-and-answering-questions,173,1,0,0,1
Dec 20 2013,Kris Guay,Q&A for EA Deferred and Regular Action students,http://mitadmissions.org/blogs/entry/qa-for-ea-deferred-and-regular-action-students,174,3,0,3,6
Dec 19 2013,Kirsten L. '15 ,YO!,http://mitadmissions.org/blogs/entry/yo,175,45,4,9,58
Dec 17 2013,Anna H. '14,There are no imposters in the Class of 2018,http://mitadmissions.org/blogs/entry/there-are-no-imposters-in-the-class-of-2018,177,147,19,19,185
Dec 14 2013,Chris Peterson,MIT Early Action Decisions Now Available Online,http://mitadmissions.org/blogs/entry/mit-early-action-decisions-now-available-online1,180,69,18,23,110
Dec 14 2013,Decisions,Open Thread: Admitted Early,http://mitadmissions.org/blogs/entry/open-thread-admitted-early,180,6,1,0,7
Dec 14 2013,Decisions,Open Thread: Deferred Early,http://mitadmissions.org/blogs/entry/open-thread-deferred-early,180,0,1,0,1
Dec 14 2013,Decisions,Open Thread: Not Admitted Early,http://mitadmissions.org/blogs/entry/open-thread-not-admitted-early,180,0,0,0,0
Dec 13 2013,Anastassia B. '16,TEDxCambridge!,http://mitadmissions.org/blogs/entry/tedxcambridge,181,22,1,8,31
Dec 13 2013,Vincent A. '17,Waiting,http://mitadmissions.org/blogs/entry/waiting1,181,5,1,1,7
Dec 11 2013,Anna H. '14,Im laughing out loud,http://mitadmissions.org/blogs/entry/im-laughing-out-loud,183,1,0,0,1
Dec 11 2013,Vincent A. '17,2.009 Final Presentation Recap,http://mitadmissions.org/blogs/entry/2.009-final-presentation-recap,183,1,2,0,3
Dec 10 2013,Krystal L. '17,Catalogue of Fridays,http://mitadmissions.org/blogs/entry/catalogue-of-fridays,184,1,0,0,1
Dec 10 2013,Anna H. '14,Q&A,http://mitadmissions.org/blogs/entry/qa3,184,19,2,2,23
Dec 10 2013,Allan K. '17,Thoughts on Snow,http://mitadmissions.org/blogs/entry/thoughts-on-snow,184,1,0,0,1
Dec 8 2013,Michael C. '16,"twerking, MIT style",http://mitadmissions.org/blogs/entry/twerking-mit-style,186,69,8,1,78
Dec 7 2013,Ceri R. '16,Unintentional Hiatuses,http://mitadmissions.org/blogs/entry/unintentional-hiatuses,187,2,0,0,2
Dec 7 2013,Anna H. '14,Life Lessons From Pistol Class,http://mitadmissions.org/blogs/entry/life-lessons-from-pistol-class,187,17,6,1,24
Dec 7 2013,Allan K. '17,Christmas: The Playlist,http://mitadmissions.org/blogs/entry/christmas-the-playlist,187,0,0,0,0
Dec 6 2013,Chris Peterson,"MIT EA Decisions To Be Posted Saturday, 12/14, at 12:14 PM ET",http://mitadmissions.org/blogs/entry/mit-ea-decisions-to-be-posted-saturday-12-14-at-1214-pm-est,188,71,11,9,91
Dec 5 2013,Vincent A. '17,In Prison,http://mitadmissions.org/blogs/entry/in-prison,189,3,1,2,6
Dec 3 2013,Lydia K. '14,42 Recipes for Surviving Freshman Year (Part 1),http://mitadmissions.org/blogs/entry/42-recipes-for-surviving-freshman-year-part-1,191,12,4,22,38
Dec 3 2013,Lydia K. '14,42 Recipes for Surviving Freshman Year (Part 2),http://mitadmissions.org/blogs/entry/recipes-for-surviving-freshman-year-part-2,191,3,2,0,5
Dec 2 2013,Krystal L. '17,A Tale of Two Struggles,http://mitadmissions.org/blogs/entry/a-working-title,192,2,0,0,2
Nov 30 2013,Chris Peterson,Ask Me Anything,http://mitadmissions.org/blogs/entry/ask-me-anything2,194,1,1,0,2
Nov 30 2013,Allan K. '17,Its Beginning to Look a Lot Like Christmas,http://mitadmissions.org/blogs/entry/its-beginning-to-look-a-lot-like-christmas,194,20,0,3,23
Nov 26 2013,Anna H. '14,"Teach til you drop, then draw the Mona Lisa while blindfolded.",http://mitadmissions.org/blogs/entry/teach-til-you-drop,198,38,7,1,46
Nov 26 2013,Vincent A. '17,Feeling Good,http://mitadmissions.org/blogs/entry/feeling-good,198,2,0,0,2
Nov 25 2013,Anastassia B. '16,How to have dinner with your Professor,http://mitadmissions.org/blogs/entry/how-to-have-dinner-with-your-professor,199,18,8,3,29
Nov 25 2013,Allan K. '17,Soldering Things,http://mitadmissions.org/blogs/entry/soldering-things,199,2,1,0,3
Nov 22 2013,Michael C. '16,Aanuha cappella concert?,http://mitadmissions.org/blogs/entry/a...an...uh...a-cappella-concert,202,32,2,2,36
Nov 22 2013,Anna H. '14,"Some virtuosos play $4 million violins, and some Trojan heros wear brass rats",http://mitadmissions.org/blogs/entry/some-virtuosos-play-4-million-violins-and-some-trojan-heros-wear-brass-rats,202,11,2,0,13
Nov 19 2013,Erick P. '17,This Isnt Goodbye,http://mitadmissions.org/blogs/entry/this-isnt-goodbye,205,50,7,0,57
Nov 17 2013,Kirsten L. '15 ,Discovering Product Design through Photography,http://mitadmissions.org/blogs/entry/discovering-product-design-through-photography,207,2,2,0,4
Nov 16 2013,Michael C. '16,Navigating MIT is like flying a spacecraft*,http://mitadmissions.org/blogs/entry/navigating-mit-is-like-flying-a-spacecraft-the-most-important-things-ive-le,208,67,29,28,124
Nov 16 2013,Allan K. '17,Fashion Design at MIT,http://mitadmissions.org/blogs/entry/fashion-design-at-mit,208,20,3,6,29
Nov 14 2013,Kris Guay,Missing Documents Deadline,http://mitadmissions.org/blogs/entry/missing-documents-deadline2,210,0,0,0,0
Nov 14 2013,Anna H. '14,Spontaneous 5-Minute Classes on Whatever You Want,http://mitadmissions.org/blogs/entry/spontaneous-5-minute-classes-on-whatever-you-want,210,0,0,0,0
Nov 11 2013,Anna H. '14,Monteverdi to Mozart: 1600-1800,http://mitadmissions.org/blogs/entry/monteverdi-to-mozart-1600-1800,213,1,1,0,2
Nov 11 2013,Allan K. '17,Toons and Tasty Burgers,http://mitadmissions.org/blogs/entry/toons-and-tasty-burgers,213,0,0,0,0
Nov 11 2013,Anna H. '14,E-mails in French House,http://mitadmissions.org/blogs/entry/emails-in-french-house,213,12,4,7,23
Nov 4 2013,Vincent A. '17,Slam Dunked,http://mitadmissions.org/blogs/entry/slam-dunked,220,2,4,0,6
Nov 3 2013,Rachel D. '16,A Battle Scene to Remember,http://mitadmissions.org/blogs/entry/a-battle-scene-to-remember,221,36,16,7,59
Nov 3 2013,Krystal L. '17,Stop and Smell the Seasons,http://mitadmissions.org/blogs/entry/stop-and-smell-the-seasons,221,1,1,0,2
Nov 3 2013,Allan K. '17,Becoming a Princess,http://mitadmissions.org/blogs/entry/becoming-a-princess,221,0,1,0,1
Nov 1 2013,Ceri R. '16,All Hallows Eve,http://mitadmissions.org/blogs/entry/all-hallows-eve,223,0,2,0,2
Oct 30 2013,Anna H. '14,My 21st Birthday,http://mitadmissions.org/blogs/entry/my-21st-birthday,225,3,0,0,3
Oct 29 2013,Matt McGann '00,Answering Your Questions: EA Deadline Week,http://mitadmissions.org/blogs/entry/answering-your-questions-ea-deadline-week,226,1,1,0,2
Oct 29 2013,Vincent A. '17,"Milk, Cookies and Dangerous Secrets",http://mitadmissions.org/blogs/entry/milk-cookies-and-dangerous-secrets,226,2,3,0,5
Oct 28 2013,Anna H. '14,Vertigo,http://mitadmissions.org/blogs/entry/vertigo,227,4,0,0,4
Oct 26 2013,Ceri R. '16,Time Flies,http://mitadmissions.org/blogs/entry/time-flies2,229,1,0,0,1
Oct 21 2013,Latasha Boyd,QuestBridge 2013 FAQs,http://mitadmissions.org/blogs/entry/questbridge-2013-faqs,234,1,5,0,6
Oct 20 2013,Allan K. '17,Weekend Shenanigans,http://mitadmissions.org/blogs/entry/weekend-shenanigans,235,0,0,0,0
Oct 20 2013,Vincent A. '17,Alpha Delta Phi,http://mitadmissions.org/blogs/entry/alpha-delta-phi,235,81,7,15,103
Oct 19 2013,Anna H. '14,Deadlines and Habits,http://mitadmissions.org/blogs/entry/deadlines-and-habits,236,1,1,0,2
Oct 17 2013,Erick P. '17,A Couple of Firsts,http://mitadmissions.org/blogs/entry/a-couple-of-firsts,238,17,4,0,21
Oct 17 2013,Chris Peterson,Early Action Updates 2013,http://mitadmissions.org/blogs/entry/early-action-updates-2013,238,2,1,0,3
Oct 15 2013,"Dr. Dawn '04, MS '06, PhD '11",MIT Students Are Cool: Brian Chan edition,http://mitadmissions.org/blogs/entry/mit-students-are-cool-brian-chan-edition,240,48,6,2,56
Oct 13 2013,Allan K. '17,HackMIT: Coding over Cookies,http://mitadmissions.org/blogs/entry/hackmit-coding-over-cookies,242,22,8,2,32
Oct 8 2013,Krystal L. '17,Science! at the BAH!Fest,http://mitadmissions.org/blogs/entry/science-at-the-bahfest,247,5,5,3,13
Oct 7 2013,Ceri R. '16,Life is like a Game,http://mitadmissions.org/blogs/entry/life-is-like-a-game1,248,56,14,10,80
Oct 6 2013,Rachel D. '16,An Alumni Barbecue,http://mitadmissions.org/blogs/entry/an-alumni-barbecue,249,7,5,10,22
Oct 5 2013,Kirsten L. '15 ,I shouldve started this earlier,http://mitadmissions.org/blogs/entry/i-shouldve-started-this-earlier,250,21,2,3,26
Oct 5 2013,Vincent A. '17,MOMENTOS IMPRESIONANTES,http://mitadmissions.org/blogs/entry/momentos-impresionantes,250,38,6,3,47
Oct 2 2013,Chris S. '11,Notes on the Interview (the EC edition!),http://mitadmissions.org/blogs/entry/notes-on-the-interview-the-ec-edition,253,3,7,0,10
Oct 2 2013,Anna H. '14,The First Day of Classes,http://mitadmissions.org/blogs/entry/the-first-day-of-classes,253,6,3,1,10
Oct 1 2013,Allan K. '17,The Art and Craft of Taking Notes,http://mitadmissions.org/blogs/entry/the-art-and-craft-of-note-taking,254,4,1,2,7
Oct 1 2013,"Dr. Dawn '04, MS '06, PhD '11",FAQ for Maker Portfolios,http://mitadmissions.org/blogs/entry/faq-for-maker-portfolios,254,0,2,0,2
Sep 26 2013,Vincent A. '17,"MIT.01: Intro to the Institute, part 3 (Finals)",http://mitadmissions.org/blogs/entry/mit.01-intro-to-the-institute-part-3-finals1,259,12,2,1,15
Sep 24 2013,Elizabeth C. '13,Leaving,http://mitadmissions.org/blogs/entry/leaving,261,106,5,22,133
Sep 22 2013,Ceri R. '16,All The Worlds A Stage,http://mitadmissions.org/blogs/entry/all-the-worlds-a-stage,263,0,0,0,0
Sep 21 2013,Krystal L. '17,A Study Break. Or two or three.,http://mitadmissions.org/blogs/entry/a-study-break.-or-two-or-three,264,1,0,0,1
Sep 21 2013,Anna H. '14,Q&A,http://mitadmissions.org/blogs/entry/qa2,264,0,1,0,1
Sep 21 2013,Allan K. '17,Fanboying at the Career Fair,http://mitadmissions.org/blogs/entry/fanboying-at-the-career-fair,264,6,4,0,10
Sep 19 2013,Allan K. '17,Kindred Spirits,http://mitadmissions.org/blogs/entry/kindred-spirits,266,4,1,2,7
Sep 18 2013,Anna H. '14,Short Answers to Big Questions,http://mitadmissions.org/blogs/entry/short-answers-to-big-questions,267,1,0,0,1
Sep 17 2013,Erick P. '17,Two Truths and a Lie,http://mitadmissions.org/blogs/entry/two-truths-and-a-lie,268,74,4,6,84
Sep 16 2013,Vincent A. '17,"MIT.01: Intro to the Institute, part 2",http://mitadmissions.org/blogs/entry/mit.01-intro-to-the-institute-part-2,269,12,1,1,14
Sep 16 2013,Ceri R. '16,The Boston Festival of Indie Games,http://mitadmissions.org/blogs/entry/the-boston-festival-of-indie-games,269,10,2,1,13
Sep 15 2013,Anna H. '14,The 2013 Ig Nobel Prize Lectures,http://mitadmissions.org/blogs/entry/the-2013-ig-nobel-prize-lectures,270,25,3,12,40
Sep 14 2013,Elizabeth C. '13,Summertime Science,http://mitadmissions.org/blogs/entry/summertime-science,271,8,0,0,8
Sep 13 2013,Ceri R. '16,"Life, the Universe, and Everything",http://mitadmissions.org/blogs/entry/life-the-universe-and-everything,272,2,3,1,6
Sep 11 2013,Latasha Boyd,Remembrance,http://mitadmissions.org/blogs/entry/remembrance,274,0,0,0,0
Sep 10 2013,Anna H. '14,We have nice things on the walls,http://mitadmissions.org/blogs/entry/we-have-nice-things-on-the-walls,275,1,0,0,1
Sep 9 2013,Latasha Boyd,Why Apply?,http://mitadmissions.org/blogs/entry/why-apply,276,21,2,3,26
Sep 8 2013,Vincent A. '17,"MIT.01: Intro to the Institute, part 1",http://mitadmissions.org/blogs/entry/0.00-intro-to-the-institute-part-1,277,7,3,2,12
Sep 7 2013,Anna H. '14,A not-so-typical day in the post-FYRE life,http://mitadmissions.org/blogs/entry/a-not-so-typical-day-in-the-post-fyre-life,278,3,0,0,3
Sep 7 2013,Anastassia B. '16,What is an Incomplete Grade?,http://mitadmissions.org/blogs/entry/what-is-an-incomplete-grade,278,15,3,0,18
Sep 7 2013,Krystal L. '17,More Milk Please,http://mitadmissions.org/blogs/entry/more-milk-please,278,2,0,0,2
Sep 6 2013,Emad T. '14,The second-to-last first two days of class,http://mitadmissions.org/blogs/entry/the-second-to-last-first-two-days-of-class,279,2,1,1,4
Sep 6 2013,Allan K. '17,Finding Balance,http://mitadmissions.org/blogs/entry/finding-balance,279,22,5,1,28
Sep 5 2013,Michael C. '16,year 2 of the course 2,http://mitadmissions.org/blogs/entry/year-2-of-the-course-2,280,6,2,2,10
Sep 5 2013,Anna H. '14,"The Classes of Semesters Past, Present, and Future",http://mitadmissions.org/blogs/entry/my-course-history,280,1,0,2,3
Sep 3 2013,Anna H. '14,Live from Reg Day,http://mitadmissions.org/blogs/entry/live-from-reg-day,282,0,1,0,1
Sep 3 2013,Ceri R. '16,New Years Resolution,http://mitadmissions.org/blogs/entry/new-years-resolution,282,2,0,0,2
Sep 3 2013,Chris Peterson,Class of 2017 By The Numbers,http://mitadmissions.org/blogs/entry/class-of-2017-by-the-numbers,282,5,6,1,12
Sep 2 2013,Natnael G. '15,Four Weeks of Freedom,http://mitadmissions.org/blogs/entry/four-weeks-of-freedom,283,9,1,3,13
Aug 28 2013,Anna H. '14,Laser Graffiti,http://mitadmissions.org/blogs/entry/laser-graffiti,288,29,3,9,41
Aug 28 2013,Matt McGann '00,Your Questions,http://mitadmissions.org/blogs/entry/your-questions,288,1,0,0,1
Aug 27 2013,Connie H. '15,DEALicious,http://mitadmissions.org/blogs/entry/dealicious,289,14,3,0,17
Aug 27 2013,Natasha B. '16,"Thanks, man",http://mitadmissions.org/blogs/entry/thanks-man,289,5,0,0,5
Aug 26 2013,Natnael G. '15,Taking Care of Yourself,http://mitadmissions.org/blogs/entry/taking-care-of-yourself,290,38,10,7,55
Aug 23 2013,Emad T. '14,Open SesameRing.,http://mitadmissions.org/blogs/entry/open-sesame-ring,293,9,2,0,11
Aug 23 2013,Lydia K. '14,REX at Random Hall,http://mitadmissions.org/blogs/entry/rex-at-random-hall,293,200,24,25,249
Aug 22 2013,"Dr. Dawn '04, MS '06, PhD '11",Introducing Maker Portfolios!,http://mitadmissions.org/blogs/entry/introducing...-maker-portfolios,294,20,11,6,37
Aug 22 2013,Rachel D. '16,Let There Be Prefrosh!,http://mitadmissions.org/blogs/entry/let-there-be-prefrosh,294,0,0,0,0
Aug 21 2013,Lydia K. '14,Skies over MacGregor,http://mitadmissions.org/blogs/entry/skies-over-macgregor,295,3,1,2,6
Aug 20 2013,Anna H. '14,An End,http://mitadmissions.org/blogs/entry/an-end,296,2,1,0,3
Aug 19 2013,Natnael G. '15,HT@MIT: Academic Resources,http://mitadmissions.org/blogs/entry/htmit-resources,297,16,6,7,29
Aug 19 2013,Rachel D. '16,Summer on the West Coast,http://mitadmissions.org/blogs/entry/summer-on-the-west-coast,297,0,2,0,2
Aug 16 2013,Chris Peterson,THE APPLICATION IS LIVE!,http://mitadmissions.org/blogs/entry/its-live,300,122,18,21,161
Aug 15 2013,Michael C. '16,9 things I wish I had known before freshman year,http://mitadmissions.org/blogs/entry/9-things-i-wish-i-had-known-before-freshman-year-hows-my-linkbait,301,13,12,0,25
Aug 14 2013,Connie H. '15,The Best of Times,http://mitadmissions.org/blogs/entry/the-best-of-times,302,17,7,0,24
Aug 12 2013,Natnael G. '15,From One Cambridge To The Other,http://mitadmissions.org/blogs/entry/from-one-cambridge-to-the-other,304,21,2,7,30
Aug 11 2013,Rachel D. '16,Healthy Eating Craze,http://mitadmissions.org/blogs/entry/healthy-eating-craze,305,0,1,0,1
Aug 6 2013,Lydia K. '14,A Few of my Favorite Things (Counting Blessings),http://mitadmissions.org/blogs/entry/counting-blessings,310,5,1,10,16
Aug 5 2013,Anna H. '14,My first music festival,http://mitadmissions.org/blogs/entry/my-first-music-festival,311,0,0,0,0
Aug 1 2013,Chris Peterson,Our Essay Questions,http://mitadmissions.org/blogs/entry/our-essay-questions,315,8,12,1,21
Jul 30 2013,Anna H. '14,Writing is useful for science.,http://mitadmissions.org/blogs/entry/writing-is-useful-for-science,317,1,3,0,4
Jul 29 2013,Natnael G. '15,A Summer of Learning,http://mitadmissions.org/blogs/entry/a-summer-of-learning,318,3,3,5,11
Jul 22 2013,Natnael G. '15,A Bit About Me,http://mitadmissions.org/blogs/entry/a-bit-about-me,325,3,2,2,7
Jul 22 2013,Chris Peterson,Blogger Application 2013!,http://mitadmissions.org/blogs/entry/blogger-application-2013,325,4,9,3,16
Jul 21 2013,Lydia K. '14,Bedbugs (fiction),http://mitadmissions.org/blogs/entry/bedbugs-fiction,326,2,1,1,4
Jul 20 2013,Anna H. '14,Ingredients for a black hole: 1. Hydrogen 2. Soda 3. Bottle,http://mitadmissions.org/blogs/entry/ingredients-for-a-black-hole-1.-hydrogen-2.-soda-3.-bottle,327,5,1,0,6
Jul 20 2013,Stanley G.,Eastward ho!,http://mitadmissions.org/blogs/entry/eastward-ho,327,0,2,0,2
Jul 19 2013,Chris Peterson,hello again,http://mitadmissions.org/blogs/entry/hello-again,328,6,0,4,10
Jul 15 2013,Natnael G. '15,HT@MIT: Foodie Edition,http://mitadmissions.org/blogs/entry/htmit-foodie-edition,332,3,1,3,7
Jul 15 2013,Rachel D. '16,Wooo Summer,http://mitadmissions.org/blogs/entry/wooo-summer,332,0,1,0,1
Jul 12 2013,Kim Hunter '86,There is No Place Like Home,http://mitadmissions.org/blogs/entry/there-is-no-place-like-home,335,83,12,9,104
Jul 11 2013,Anna H. '14,Waterfall Camping in Shenandoah National Park,http://mitadmissions.org/blogs/entry/waterfall-camping-in-shenandoah-national-forest,336,1,0,0,1
Jul 7 2013,Jenny X. '13,Unpacking Surprises,http://mitadmissions.org/blogs/entry/unpacking-lifes-surprises,340,1,2,0,3
Jul 5 2013,Anna H. '14,Disco balls in space,http://mitadmissions.org/blogs/entry/disco-balls-in-space1,342,3,0,0,3
Jul 5 2013,Rachel F. '12,A Postcard From The Green Building,http://mitadmissions.org/blogs/entry/a-postcard-from-the-green-building,342,25,5,2,32
Jul 5 2013,Anna H. '14,Coworker Shenanigans,http://mitadmissions.org/blogs/entry/coworker-shenanigans,342,0,1,0,1
Jul 5 2013,Lydia K. '14,Independence Day Fireworks in Boston,http://mitadmissions.org/blogs/entry/independence-day,342,2,1,0,3
Jul 3 2013,Lydia K. '14,All Aboard the Rage Bus,http://mitadmissions.org/blogs/entry/people-on-buses,344,3,1,3,7
Jun 26 2013,Chris LaBounty,Tchau! Labs vai para a praia!,http://mitadmissions.org/blogs/entry/tchau-labs-vai-para-a-praia,351,5,0,1,6
Jun 24 2013,Elizabeth C. '13,All I Ever Really Needed to Know I Learned in Kindergarten (and at MIT),http://mitadmissions.org/blogs/entry/all-i-ever-really-needed-to-know-i-learned-in-kindergarten-and-at-mit,353,46,18,32,96
Jun 18 2013,Hamsika C. '13,Farewell,http://mitadmissions.org/blogs/entry/farewell,359,34,3,4,41
Jun 15 2013,Anna H. '14,Summer Decisions,http://mitadmissions.org/blogs/entry/summer-decisions,362,2,1,0,3
Jun 15 2013,Anna H. '14,Im sitting on a bus,http://mitadmissions.org/blogs/entry/im-sitting-on-a-bus,362,1,0,0,1
Jun 15 2013,Connie H. '15,New York City,http://mitadmissions.org/blogs/entry/new-york-city,362,1,0,0,1
Jun 10 2013,Jenny X. '13,How MIT students are trying to change education,http://mitadmissions.org/blogs/entry/how-a-group-of-mit-students-are-trying-to-change-education,367,9,1,0,10
Jun 8 2013,Ana V. '15 ,4 Years,http://mitadmissions.org/blogs/entry/four-years,369,44,3,2,49
May 31 2013,Lydia K. '14,DNA and How to Extract It,http://mitadmissions.org/blogs/entry/spark-dna-class,377,3,8,1,12
May 30 2013,Elizabeth C. '13,"Movie Marathon, Pt. I",http://mitadmissions.org/blogs/entry/movie-marathon-pt.-i,378,0,1,4,5
May 25 2013,Anna H. '14,Summer begins,http://mitadmissions.org/blogs/entry/Summer-begins,383,1,0,0,1
May 17 2013,Michael C. '16,the journey to PLAYsentations,http://mitadmissions.org/blogs/entry/the-journey-to-playsentations,391,9,4,2,15
May 13 2013,Mikey Yang '05,Wait List Decisions 2013,http://mitadmissions.org/blogs/entry/wait-list-update-2013,395,16,7,11,34
May 11 2013,Anna H. '14,A last-minute barbecue for hundreds of people,http://mitadmissions.org/blogs/entry/a-last-minute-barbecue-for-hundreds-of-people,397,1,2,0,3
May 10 2013,Natasha B. '16,"Sal Khan, Gabriel Abrantes, and the Man in the Shiny Red Satan Suit",http://mitadmissions.org/blogs/entry/sal-khan-gabriel-abrantes-and-the-man-in-the-shiny-red-satan-suit,398,13,1,0,14
May 8 2013,Jenny X. '13,Night Vision,http://mitadmissions.org/blogs/entry/night-vision,400,15,1,3,19
May 7 2013,Chris LaBounty,Transfer Decisions to be Released Today,http://mitadmissions.org/blogs/entry/transfer-decisions-to-be-released-today,401,3,1,0,4
May 4 2013,Natnael G. '15,HT@MIT: Cantab Lounge Poetry Slam,http://mitadmissions.org/blogs/entry/htmit-cantab-lounge-poetry-slam,404,9,1,0,10
May 4 2013,Anna H. '14,MIT HSSP and Stanford Splash!,http://mitadmissions.org/blogs/entry/seven-fundamental-questions-and-a-field-trip-to-the-west-coast,404,6,1,0,7
May 2 2013,Natasha B. '16,Right NOW,http://mitadmissions.org/blogs/entry/right-now,406,1,0,0,1
Apr 30 2013,Lydia K. '14,Random Ceiling Tiles,http://mitadmissions.org/blogs/entry/random-ceiling-tiles,408,12,4,2,18
Apr 30 2013,Matt McGann '00,Decision Day Eve,http://mitadmissions.org/blogs/entry/decision-day-eve,408,1,2,1,4
Apr 27 2013,Lydia K. '14,Hope for the Axolotl: On the Amphibian Extinction Crisis,http://mitadmissions.org/blogs/entry/hope-for-the-axolotl,411,20,7,10,37
Apr 27 2013,Michael C. '16,I GOT TWENTY DOLLARS IN MY POCKET,http://mitadmissions.org/blogs/entry/i-got-twenty-dollars-in-my-pocket,411,7,4,0,11
Apr 26 2013,Matt McGann '00,Getting Back to Normal,http://mitadmissions.org/blogs/entry/getting-back-to-normal,412,0,1,0,1
Apr 24 2013,Michael C. '16,MIT honors Officer Sean Collier (photoblog),http://mitadmissions.org/blogs/entry/mit-honors-officer-sean-collier,414,9,9,0,18
Apr 20 2013,Linh V.  '13,Thoughts. Future. Kindness,http://mitadmissions.org/blogs/entry/thoughts1,418,16,7,1,24
Apr 19 2013,Kirsten L. '15 ,Turning on the Light,http://mitadmissions.org/blogs/entry/turning-on-the-light,419,79,6,6,91
Apr 19 2013,Matt McGann '00,Tragedy for MIT and Boston,http://mitadmissions.org/blogs/entry/tragedy-for-mit-and-boston,419,200,65,47,312
Apr 17 2013,Anna H. '14,"What I wish Id known, and what Im glad I knew",http://mitadmissions.org/blogs/entry/what-i-wish-i-had-known-and-what-im-glad-i-knew,421,85,15,9,109
Apr 17 2013,Jess K. '10,Donate for Eric and Ann Whalley,http://mitadmissions.org/blogs/entry/donate-for-eric-and-ann-whalley,421,1,9,0,10
Apr 16 2013,Rachel D. '16,On the other side of CPW,http://mitadmissions.org/blogs/entry/on-the-other-side-of-cpw,422,0,0,0,0
Apr 16 2013,Michael C. '16,Together.,http://mitadmissions.org/blogs/entry/together,422,17,4,1,22
Apr 15 2013,Anna H. '14,MITs Tribute to Boston,http://mitadmissions.org/blogs/entry/mits-tribute-to-boston,423,0,0,0,0
Apr 13 2013,Lydia K. '14,Fantasy Feast,http://mitadmissions.org/blogs/entry/fantasy-feast,425,28,3,2,33
Apr 13 2013,Anastassia B. '16,retreating and proceeding,http://mitadmissions.org/blogs/entry/new-estaloam-philosophy,425,1,0,0,1
Apr 11 2013,Lydia K. '14,CPW at Random Hall!,http://mitadmissions.org/blogs/entry/cpw-at-random-hall,427,1,0,0,1
Apr 10 2013,Kim Hunter '86,CPW 2013The Parent Experience!,http://mitadmissions.org/blogs/entry/cpw-2013...the-parent-experience,428,0,1,0,1
Apr 9 2013,Anna H. '14,A Letter to CPW Prefrosh,http://mitadmissions.org/blogs/entry/a-letter-to-cpw-prefrosh,429,0,0,0,0
Apr 9 2013,Rachel D. '16,AHHH CPW!!,http://mitadmissions.org/blogs/entry/ahhh-cpw,429,3,7,4,14
Apr 8 2013,Elizabeth C. '13,Engineering,http://mitadmissions.org/blogs/entry/engineer,430,17,8,4,29
Apr 7 2013,Michael C. '16,Freshman FAQs,http://mitadmissions.org/blogs/entry/freshman-faqs,431,2,1,0,3
Apr 4 2013,Natnael G. '15,Hidden Treasures @ MIT: Pistol,http://mitadmissions.org/blogs/entry/hidden-treasures-mit-pistol,434,17,1,6,24
Apr 4 2013,Chris S. '11,With Apologies to Dr. Seuss,http://mitadmissions.org/blogs/entry/with-apologies-to-dr.-seuss,434,7,0,1,8
Apr 2 2013,Beatriz Valdez,"QuestBridge, CPW, and YOU!",http://mitadmissions.org/blogs/entry/questbridge-cpw-and-you,436,11,4,4,19
Mar 31 2013,Rachel D. '16,Exploring Boston,http://mitadmissions.org/blogs/entry/exploring-boston,438,0,0,0,0
Mar 31 2013,Ana V. '15 ,"August, Airplanes, and why not throw in Spring Break, too?",http://mitadmissions.org/blogs/entry/august-airplanes-and-everything,438,5,1,2,8
Mar 22 2013,Anna H. '14,My First Astrophotography,http://mitadmissions.org/blogs/entry/astrophotography,447,0,0,0,0
Mar 22 2013,Anna H. '14,"One weekend in New York, two (very different) operas",http://mitadmissions.org/blogs/entry/one-weekend-in-new-york-two-very-different-operas,447,0,0,0,0
Mar 21 2013,Elizabeth C. '13,The Craziest of Weeks,http://mitadmissions.org/blogs/entry/the-craziest-of-weeks,448,5,0,0,5
Mar 21 2013,Chris LaBounty,Think About This,http://mitadmissions.org/blogs/entry/think-about-this,448,52,14,21,87
Mar 19 2013,Natasha B. '16,Fancy Feast & Happy People,http://mitadmissions.org/blogs/entry/fancy-feast-happy-people-all-ive-gotta-do,450,28,11,2,41
Mar 19 2013,Kim Hunter '86,Admitted Student Gatherings,http://mitadmissions.org/blogs/entry/admitted-student-gatherings2,450,0,1,0,1
Mar 15 2013,Susan Sullivan,After the Award,http://mitadmissions.org/blogs/entry/after-the-award,454,0,4,0,4
Mar 15 2013,Kris Guay,More info for Admitted Students,http://mitadmissions.org/blogs/entry/more-info-for-admitted-students,454,1,1,0,2
Mar 15 2013,Matt McGann '00,FAQ: Waitlist,http://mitadmissions.org/blogs/entry/faq-waitlist,454,4,4,2,10
Mar 14 2013,Chris LaBounty,Decisions Released TODAY @ 6:28 p.m.,http://mitadmissions.org/blogs/entry/decisions-released-today-628-p.m,455,20,7,8,35
Mar 13 2013,Anna H. '14,If youre scared of decision day,http://mitadmissions.org/blogs/entry/if-youre-scared-of-decision-day,456,12,4,10,26
Mar 12 2013,Mikey Yang '05,As we hurtle towards Pi Day,http://mitadmissions.org/blogs/entry/as-we-hurtle-towards-pi-day,457,40,5,2,47
Mar 12 2013,Lydia K. '14,Admissions Decisions and Mystery Hunt,http://mitadmissions.org/blogs/entry/stress-relief,457,12,5,3,20
Mar 10 2013,Richard Parker,BREAKING NEWS!,http://mitadmissions.org/blogs/entry/breaking-news,459,378,66,103,547
Mar 10 2013,Stanley G.,Jellyfishing,http://mitadmissions.org/blogs/entry/jellyfishing,459,1,0,0,1
Mar 7 2013,Anna H. '14,Consilience,http://mitadmissions.org/blogs/entry/consilience,462,1,0,0,1
Mar 6 2013,Jenny X. '13,We Eat At Food Trucks,http://mitadmissions.org/blogs/entry/we-eat-at-food-trucks,463,3,2,0,5
Mar 3 2013,Anna H. '14,"The Junior Spring Line-Up, Part 1: Classes",http://mitadmissions.org/blogs/entry/the-junior-spring-line-up-part-1-classes,466,3,1,1,5
Mar 3 2013,Michael C. '16,Everyone at MIT should take this class.,http://mitadmissions.org/blogs/entry/everyone-at-mit-should-take-this-class,466,13,3,4,20
Mar 2 2013,Kirsten L. '15 ,We were worried,http://mitadmissions.org/blogs/entry/we-were-worried,467,29,5,4,38
Mar 1 2013,Michael C. '16,"Nate Silver visits MIT (or, do witches exist in real life?)",http://mitadmissions.org/blogs/entry/nate-silver-visits-mit-or-do-witches-exist-in-real-life,468,8,3,5,16
Feb 24 2013,Ana V. '15 ,2015 Brass Rat,http://mitadmissions.org/blogs/entry/brassy-rat,473,22,8,5,35
Feb 24 2013,Anna H. '14,24 Hours,http://mitadmissions.org/blogs/entry/24-hours,473,1,0,0,1
Feb 21 2013,Rachel D. '16,Quarrying Around,http://mitadmissions.org/blogs/entry/quarrying-around,476,1,2,0,3
Feb 20 2013,Jenny X. '13,This is it.,http://mitadmissions.org/blogs/entry/this-is-it,477,12,1,3,16
Feb 18 2013,Anna H. '14,"A Series of Embarrassing Events, Part 3",http://mitadmissions.org/blogs/entry/a-series-of-embarrassing-events-part-3,479,5,2,10,17
Feb 18 2013,Lydia K. '14,Guest Entry: MIT Cycling Team Training Camp,http://mitadmissions.org/blogs/entry/guest-entry-mit-cycling-team-training-camp,479,15,3,2,20
Feb 18 2013,Hamsika C. '13,Hitting Rewind on 2013,http://mitadmissions.org/blogs/entry/rewinding-2013,479,0,0,0,0
Feb 16 2013,Lydia K. '14,Two Valentines Day Serenades,http://mitadmissions.org/blogs/entry/v-day,481,8,2,0,10
Feb 16 2013,Anna H. '14,"A Series of Embarrassing Events, Part 2",http://mitadmissions.org/blogs/entry/a-series-of-embarrassing-events-part-2,481,3,0,0,3
Feb 15 2013,Anna H. '14,"A Series of Embarrassing Events, Part 1",http://mitadmissions.org/blogs/entry/a-series-of-embarrassing-events-part-1,482,2,0,0,2
Feb 13 2013,Rachel D. '16,New Semester,http://mitadmissions.org/blogs/entry/new-semester,484,2,0,0,2
Feb 10 2013,Jenny X. '13,One More Look At Our Snow Globe Life,http://mitadmissions.org/blogs/entry/snowglobe-life,487,2,0,0,2
Feb 9 2013,Anna H. '14,"The past four weeks, in maps.",http://mitadmissions.org/blogs/entry/iap-2013-an-overview-with-maps,488,1,0,0,1
Feb 9 2013,Michael C. '16,The Great Snowball Fight of 2013,http://mitadmissions.org/blogs/entry/the-great-snowball-fight-of-2013,488,61,20,5,86
Feb 9 2013,Connie H. '15,Nemo Found,http://mitadmissions.org/blogs/entry/nemo-found,488,4,0,0,4
Feb 4 2013,Connie H. '15,Techfair,http://mitadmissions.org/blogs/entry/live-blogging-from-techfair,493,23,4,1,28
Feb 4 2013,Kirsten L. '15 ,The Story of the 5 Wits,http://mitadmissions.org/blogs/entry/the-story-of-the-5-wits,493,22,3,0,25
Jan 30 2013,Michael C. '16,How do you convince MIT students to dress nicely?,http://mitadmissions.org/blogs/entry/how-do-you-convince-mit-students-to-dress-nicely,498,3,1,0,4
Jan 29 2013,Emad T. '14,Premed and Me (frankly speaking),http://mitadmissions.org/blogs/entry/premed-and-me-frankly-speaking,499,1,0,0,1
Jan 28 2013,Michael C. '16,The Starving Students Guide to Cooking For Yourself,http://mitadmissions.org/blogs/entry/the-starving-students-guide-to-cooking-for-yourself,500,15,14,12,41
Jan 27 2013,Rachel D. '16,Bad Ideas Weekend,http://mitadmissions.org/blogs/entry/bad-ideas-weekend,501,0,0,0,0
Jan 26 2013,Lydia K. '14,My Friend the Parasitic Scientist,http://mitadmissions.org/blogs/entry/my-friend-the-parasitic-scientist,502,8,4,10,22
Jan 22 2013,Natnael G. '15,Picking A Southwest Flight Seat,http://mitadmissions.org/blogs/entry/picking-a-southwest-flight-seat,506,14,2,3,19
Jan 20 2013,Stanley G.,Class Crossover,http://mitadmissions.org/blogs/entry/class-crossover,508,0,2,0,2
Jan 20 2013,Elizabeth C. '13,Calm Down and Breathe,http://mitadmissions.org/blogs/entry/calm-down-and-breathe,508,7,1,0,8
Jan 16 2013,Chris LaBounty,Mandatory: MIT Mid Year Report,http://mitadmissions.org/blogs/entry/mandatory-mit-mid-year-report,512,3,6,0,9
Jan 16 2013,Connie H. '15,"Lace, Gourmet Candy and Dorothy",http://mitadmissions.org/blogs/entry/lace-gourmet-candy-and-dorothy,512,0,0,0,0
Jan 16 2013,Michael C. '16,Winter is coming.,http://mitadmissions.org/blogs/entry/winter-is-coming,512,1,0,0,1
Jan 15 2013,Anna H. '14,The American Astronomical Societys Winter Conference: 2013 Edition,http://mitadmissions.org/blogs/entry/the-american-astronomical-society-winter-conference-2013-edition,513,24,2,7,33
Jan 14 2013,Elizabeth C. '13,Adulthood,http://mitadmissions.org/blogs/entry/adulthood,514,24,4,2,30
Jan 12 2013,Anastassia B. '16,Final-ly!,http://mitadmissions.org/blogs/entry/final-ly,516,32,3,4,39
Jan 10 2013,Jenny X. '13,Falling in Love with a Language at MIT,http://mitadmissions.org/blogs/entry/falling-in-love-with-a-language1,518,21,8,5,34
Jan 8 2013,Stanley G.,Mirrors,http://mitadmissions.org/blogs/entry/mirrors,520,2,0,0,2
Jan 4 2013,Anna H. '14,What can you do with a bad grade in quantum?,http://mitadmissions.org/blogs/entry/what-can-you-do-with-a-bad-grade-in-quantum,524,9,1,2,12
Jan 3 2013,Mikey Yang '05,MIT Regular Action Deadline Update,http://mitadmissions.org/blogs/entry/mit-regular-action-deadline-update,525,0,0,0,0
Jan 2 2013,Chris LaBounty,Check the Mail Pyramid!,http://mitadmissions.org/blogs/entry/check-the-mail-pyramid,526,35,10,18,63
Dec 31 2012,Mikey Yang '05,MIT Regular Action Deadline,http://mitadmissions.org/blogs/entry/mit-regular-action-deadline,528,14,4,3,21
Dec 29 2012,Anna H. '14,SO META,http://mitadmissions.org/blogs/entry/so-meta,530,14,0,4,18
Dec 27 2012,Natasha B. '16,For Applicants,http://mitadmissions.org/blogs/entry/for-applicants,532,3,1,1,5
Dec 26 2012,Connie H. '15,Holidays with the Huangs,http://mitadmissions.org/blogs/entry/holidays-with-the-huangs,533,0,0,0,0
Dec 20 2012,Chris LaBounty,Applying Regular Action - Q&A,http://mitadmissions.org/blogs/entry/applying-regular-action-qa,539,1,0,0,1
Dec 19 2012,Anna H. '14,The Ultimate Recognition,http://mitadmissions.org/blogs/entry/the-ultimate-recognition,540,33,12,8,53
Dec 19 2012,Kris Guay,Early Action this year,http://mitadmissions.org/blogs/entry/early-action-this-year1,540,28,5,9,42
Dec 18 2012,Elizabeth C. '13,For Newtown,http://mitadmissions.org/blogs/entry/for-newtown,541,7,2,0,9
Dec 17 2012,Chris LaBounty,A Q&A for Deferred Students,http://mitadmissions.org/blogs/entry/a-qa-for-deferred-students,542,1,1,0,2
Dec 15 2012,Decisions,Open Thread: Admitted in EA!,http://mitadmissions.org/blogs/entry/open-thread-admitted-in-ea,544,5,13,11,29
Dec 15 2012,Decisions,Open Thread: Deferred in EA,http://mitadmissions.org/blogs/entry/open-thread-deferred-in-ea,544,4,3,1,8
Dec 15 2012,Decisions,Open Thread: Not Admitted in EA,http://mitadmissions.org/blogs/entry/open-thread-not-admitted-in-ea,544,3,3,6,12
Dec 14 2012,Kirsten L. '15 ,Exploring the Outdoors!,http://mitadmissions.org/blogs/entry/exploring-the-outdoors,545,3,0,0,3
Dec 13 2012,Michael C. '16,are you stressed/anxious/ [emotion] about finals/decisions/[noun]? here are some adorable dogs.,http://mitadmissions.org/blogs/entry/are-you-stressed-anxious-emotion-about-finals-decisions-noun-here-are-some,546,5,6,3,14
Dec 12 2012,Beatriz Valdez,On Tortillas and Community,http://mitadmissions.org/blogs/entry/on-tortillas-and-community,547,2,0,0,2
Dec 12 2012,Connie H. '15,Fifty Shades of Break,http://mitadmissions.org/blogs/entry/fifty-shades-of-break,547,28,7,5,40
Dec 11 2012,Ana V. '15 ,Stressful Times,http://mitadmissions.org/blogs/entry/stressful-time,548,28,1,7,36
Dec 10 2012,Natasha B. '16,Dont Waste Daylight; Dont Lose Sleep,http://mitadmissions.org/blogs/entry/dont-waste-daylight-dont-lose-sleep,549,28,2,5,35
Dec 10 2012,Anna H. '14,"Welcome back into my life, crutches",http://mitadmissions.org/blogs/entry/welcome-back-into-my-life-crutches,549,1,0,0,1
Dec 10 2012,Chris LaBounty,"MIT EA Decisions To Be Posted Saturday, 12/15, at 12:15 PM EST",http://mitadmissions.org/blogs/entry/mit-ea-decisions-to-be-posted-saturday-12-15-at-1215-pm-est,549,254,50,125,429
Dec 8 2012,Anna H. '14,Q&A,http://mitadmissions.org/blogs/entry/qa,551,4,0,0,4
Dec 7 2012,Stanley G.,A Seemingly Stressful Survey,http://mitadmissions.org/blogs/entry/a-seemingly-stressful-survey,552,0,0,0,0
Dec 7 2012,Michael C. '16,This blog post is about you.,http://mitadmissions.org/blogs/entry/this-blog-post-is-about-you,552,3,3,0,6
Dec 5 2012,Anna H. '14,Writing an essay using thumb tacks,http://mitadmissions.org/blogs/entry/writing-an-essay-using-thumb-tacks,554,3,2,0,5
Nov 30 2012,Connie H. '15,stepping back,http://mitadmissions.org/blogs/entry/stepping-back,559,6,0,0,6
Nov 29 2012,Michael C. '16,"Champagne, pistols, and my new UROP",http://mitadmissions.org/blogs/entry/champagne-pistols-and-my-new-urop,560,12,4,2,18
Nov 29 2012,Anna H. '14,MIT campus lost power!,http://mitadmissions.org/blogs/entry/mit-campus-lost-power,560,3,1,0,4
Nov 26 2012,Anna H. '14,Emergency Morale Booster Night!,http://mitadmissions.org/blogs/entry/emergency-morale-booster-night,563,3,1,1,5
Nov 25 2012,Ana V. '15 ,Engineering Poetry,http://mitadmissions.org/blogs/entry/engineering-poetry,564,2,1,0,3
Nov 25 2012,Gabe B. '13,Inspired Brainstorming,http://mitadmissions.org/blogs/entry/when-youre-feeling-inspired,564,10,2,3,15
Nov 25 2012,Emad T. '14,Post-Thanksgiving Post-stuff and Foodstuffs,http://mitadmissions.org/blogs/entry/post-thanksgiving-post-stuffs-and-foodstuffs,564,0,0,0,0
Nov 22 2012,Jenny X. '13,In Transit,http://mitadmissions.org/blogs/entry/in-transit,567,0,0,0,0
Nov 22 2012,Anna H. '14,My Class of 2014 track jacket,http://mitadmissions.org/blogs/entry/my-class-of-2014-track-jacket,567,2,3,1,6
Nov 21 2012,Anna H. '14,Splash. Was. Awesome.,http://mitadmissions.org/blogs/entry/splash.-was.-awesome,568,75,13,24,112
Nov 21 2012,Matt McGann '00,Turkey Time,http://mitadmissions.org/blogs/entry/turkey-time,568,0,1,0,1
Nov 20 2012,Stanley G.,Actually Doing Things,http://mitadmissions.org/blogs/entry/actually-doing-things,569,3,3,0,6
Nov 19 2012,Kirsten L. '15 ,Mistakes,http://mitadmissions.org/blogs/entry/mistakes,570,3,0,0,3
Nov 18 2012,Elizabeth C. '13,"The Senior Bucket List, Pt. I",http://mitadmissions.org/blogs/entry/the-senior-bucket-list-pt.-i,571,0,0,0,0
Nov 14 2012,Matt McGann '00,"EA, RA, and Transfer Updates",http://mitadmissions.org/blogs/entry/ea-ra-and-transfer-updates,575,0,0,0,0
Nov 12 2012,Anna H. '14,SCIENCE!,http://mitadmissions.org/blogs/entry/science,577,4,2,2,8
Nov 11 2012,Elizabeth C. '13,"Every now and then, my mind = blown.",http://mitadmissions.org/blogs/entry/every-now-and-then-my-mind-blown,578,5,6,17,28
Nov 10 2012,Michael C. '16,"The Infinite Corridor, set alight",http://mitadmissions.org/blogs/entry/the-infinite-corridor-set-alight,579,8,5,1,14
Nov 7 2012,Anna H. '14,Tales From Turning Twenty,http://mitadmissions.org/blogs/entry/tales-from-turning-twenty,582,0,1,0,1
Nov 7 2012,Chris LaBounty,Random Post While Reading Apps.,http://mitadmissions.org/blogs/entry/random-post-while-reading-apps,582,0,1,0,1
Oct 31 2012,Matt McGann '00,Quick EA Update,http://mitadmissions.org/blogs/entry/quick-ea-update,589,17,3,1,21
Oct 29 2012,Lydia K. '14,Meltdown,http://mitadmissions.org/blogs/entry/meltdown,591,2563,885,980,4428
Oct 28 2012,Anastassia B. '16,Halloweekend,http://mitadmissions.org/blogs/entry/halloweekend,592,40,3,10,53
Oct 28 2012,Michael C. '16,MIT PUMPKIN DROP 2012!,http://mitadmissions.org/blogs/entry/mit-pumpkin-drop-2012,592,5,4,5,14
Oct 27 2012,Anna H. '14,The little things,http://mitadmissions.org/blogs/entry/nice-little-things,593,2,0,0,2
Oct 27 2012,Anna H. '14,MIT Gangnam Style,http://mitadmissions.org/blogs/entry/mit-gangnam-style,593,152,50,75,277
Oct 24 2012,Stanley G.,Sleep is (not) for the weak,http://mitadmissions.org/blogs/entry/sleep-is-not-for-the-weak,596,2,0,0,2
Oct 23 2012,Elizabeth C. '13,My brother is cooler than me,http://mitadmissions.org/blogs/entry/my-brother-is-cooler-than-me,597,1,1,0,2
Oct 23 2012,Beatriz Valdez,Info for MIT QuestBridge Finalists,http://mitadmissions.org/blogs/entry/info-for-mit-questbridge-finalists,597,3,1,2,6
Oct 22 2012,Elizabeth C. '13,A question for you,http://mitadmissions.org/blogs/entry/a-question-for-you,598,1,0,0,1
Oct 21 2012,Kirsten L. '15 ,Roombaaaa,http://mitadmissions.org/blogs/entry/roombaaaa,599,3,1,4,8
Oct 20 2012,MISTI Program,Watch the MISTI film!,http://mitadmissions.org/blogs/entry/watch-the-misti-film,600,4,3,1,8
Oct 19 2012,Matt McGann '00,Early Action Updates,http://mitadmissions.org/blogs/entry/early-action-updates1,601,1,1,0,2
Oct 19 2012,Michael C. '16,in the pursuit of knowledge,http://mitadmissions.org/blogs/entry/in-the-pursuit-of-knowledge,601,2,3,4,9
Oct 19 2012,Susan Sullivan,Financial Aid Application Process,http://mitadmissions.org/blogs/entry/financial-aid-application-process,601,2,1,0,3
Oct 15 2012,Connie H. '15,College Interviews,http://mitadmissions.org/blogs/entry/college-interviews,605,7,5,2,14
Oct 15 2012,Anna H. '14,The one-armed violin player and the Dalai Lama,http://mitadmissions.org/blogs/entry/the-one-armed-violin-player-and-the-dalai-lama,605,2,1,4,7
Oct 15 2012,Hamsika C. '13,A Typical Friday Night,http://mitadmissions.org/blogs/entry/a-typical-friday-night,605,0,0,0,0
Oct 15 2012,Emad T. '14,Seeing The Dalai Lama,http://mitadmissions.org/blogs/entry/seeing-the-dalai-lama,605,0,0,0,0
Oct 14 2012,Ana V. '15 ,July and Unified,http://mitadmissions.org/blogs/entry/july-and-unified1,606,0,0,0,0
Oct 13 2012,Kirsten L. '15 ,Sophomore Satisfaction,http://mitadmissions.org/blogs/entry/sophomore-satisfaction,607,1,0,0,1
Oct 10 2012,Anna H. '14,Why I stayed up until 6am on Thursday,http://mitadmissions.org/blogs/entry/why-i-stayed-up-until-6am-last-wednesday,610,3,0,3,6
Oct 9 2012,Jenny X. '13,The Unlikely Candidate,http://mitadmissions.org/blogs/entry/the-unlikely-candidate,611,0,0,0,0
Oct 7 2012,Hamsika C. '13,Nerdin Out,http://mitadmissions.org/blogs/entry/nerdin-out,613,0,0,0,0
Oct 6 2012,Natnael G. '15,A Frosh No More,http://mitadmissions.org/blogs/entry/a-frosh-no-more,614,0,0,0,0
Oct 5 2012,David duKor-Jackson,Reflections from the other side of the desk,http://mitadmissions.org/blogs/entry/reflections-from-the-other-side-of-the-desk,615,0,0,0,0
Oct 3 2012,Anna H. '14,Maybe its okay to be this way,http://mitadmissions.org/blogs/entry/maybe-its-okay-to-be-this-way,617,17,4,12,33
Oct 1 2012,Hamsika C. '13,Not in my own words.,http://mitadmissions.org/blogs/entry/not-in-my-own-words,619,8,4,1,13
Sep 30 2012,Matt McGann '00,Who WIll Win the Nobel Prize?,http://mitadmissions.org/blogs/entry/who-will-win-the-nobel-prize,620,0,0,0,0
Sep 30 2012,Anna H. '14,Hack Punt Tool: The Musical,http://mitadmissions.org/blogs/entry/hack-punt-tool-the-musical,620,0,1,0,1
Sep 29 2012,Michael C. '16,"What has carcinogenic chemicals, alum bloggers, and ~art~?",http://mitadmissions.org/blogs/entry/what-has-carcinogenic-chemicals-alum-bloggers-and-art,621,4,0,0,4
Sep 29 2012,Rachel D. '16,Cats!!,http://mitadmissions.org/blogs/entry/cats,621,14,3,10,27
Sep 28 2012,Jenny X. '13,Two opportunities for high school students,http://mitadmissions.org/blogs/entry/two-opportunities-for-high-school-students,622,1,0,1,2
Sep 27 2012,Elizabeth C. '13,Cynic,http://mitadmissions.org/blogs/entry/cynic,623,27,5,10,42
Sep 27 2012,Snively '11,Stealing from the Class of 2016,http://mitadmissions.org/blogs/entry/stealing-from-the-class-of-2016,623,30,12,10,52
Sep 26 2012,Lydia K. '14,A Protocol for MIT Admissions Essays,http://mitadmissions.org/blogs/entry/a-protocol-for-mit-admissions-essays,624,6,8,2,16
Sep 24 2012,Hamsika C. '13,1 of the 101,http://mitadmissions.org/blogs/entry/1-of-the-101,626,0,0,0,0
Sep 24 2012,Chris LaBounty,Maker Faire 2012,http://mitadmissions.org/blogs/entry/maker-faire-2012,626,0,0,0,0
Sep 24 2012,Emad T. '14,Its Possible To Have Too Much Nutella,http://mitadmissions.org/blogs/entry/its-possible-to-have-too-much-nutella,626,6,2,5,13
Sep 23 2012,Lydia K. '14,Some Useful Things,http://mitadmissions.org/blogs/entry/useful-things,627,6,1,0,7
Sep 23 2012,Anna H. '14,Im sitting on my bed right now,http://mitadmissions.org/blogs/entry/im-sitting-on-my-bed-right-now1,627,0,0,0,0
Sep 22 2012,Michael C. '16,Whats a freshman like me doing at Career Fair?,http://mitadmissions.org/blogs/entry/whats-a-freshman-like-me-doing-at-career-fair,628,1,0,0,1
Sep 21 2012,Anna H. '14,The Google RISE Global Summit,http://mitadmissions.org/blogs/entry/google-rise-leadership-summit,629,2,2,0,4
Sep 21 2012,Jenny X. '13,A Tale of 8 Instagrams,http://mitadmissions.org/blogs/entry/a-tale-of-8-instagrams,629,0,0,0,0
Sep 21 2012,Beatriz Valdez,"Real, live MIT students * IN HD*",http://mitadmissions.org/blogs/entry/real-live-mit-students-in-hd,629,0,0,0,0
Sep 20 2012,Kris Guay,Together in Service,http://mitadmissions.org/blogs/entry/together-in-service,630,4,1,0,5
Sep 19 2012,Matt McGann '00,Transfer App Is Live,http://mitadmissions.org/blogs/entry/transfer-app-is-live,631,0,0,0,0
Sep 19 2012,Matt McGann '00,Your Freshman App Questions,http://mitadmissions.org/blogs/entry/your-freshman-app-questions,631,3,0,0,3
Sep 17 2012,Stanley G.,One of these labs is not like the other,http://mitadmissions.org/blogs/entry/one-of-these-labs-is-not-like-the-other,633,0,0,0,0
Sep 17 2012,Jenny X. '13,An Alternative Semester,http://mitadmissions.org/blogs/entry/an-alternative-semester,633,1,0,0,1
Sep 17 2012,Kirsten L. '15 ,The Great Gatsby,http://mitadmissions.org/blogs/entry/the-great-gatsby,633,1,0,0,1
Sep 16 2012,Ana V. '15 ,June and Flaky Biscuits,http://mitadmissions.org/blogs/entry/june-and-flaky-biscuits,634,8,1,2,11
Sep 16 2012,Anna H. '14,"The Junior Fall Line-Up, Part 2: Extracurriculars",http://mitadmissions.org/blogs/entry/the-junior-fall-line-up-part-2-extracurriculars,634,0,0,0,0
Sep 16 2012,Emad T. '14,Electrophoresis Boogaloo,http://mitadmissions.org/blogs/entry/electrophoresis-boogaloo,634,0,0,0,0
Sep 16 2012,Lydia K. '14,Classes! REX! Politics! Science! (Vlog and a Riddle),http://mitadmissions.org/blogs/entry/vlog-2,634,0,0,0,0
Sep 16 2012,Michael C. '16,A love letter to psets,http://mitadmissions.org/blogs/entry/a-love-letter-to-psets,634,16,4,1,21
Sep 15 2012,Natasha B. '16,Better Late than Never,http://mitadmissions.org/blogs/entry/weekend-to-weekend,635,0,0,0,0
Sep 15 2012,Elizabeth C. '13,Two Days in the Life,http://mitadmissions.org/blogs/entry/two-days-in-the-life,635,0,1,1,2
Sep 12 2012,Anna H. '14,"The Junior Fall Line-Up, Part 1: Classes",http://mitadmissions.org/blogs/entry/the-junior-fall-line-up-part-1-classes,638,0,0,0,0
Sep 12 2012,Kirsten L. '15 ,To the Class of 2016,http://mitadmissions.org/blogs/entry/to-the-class-of-20161,638,12,1,1,14
Sep 11 2012,Chris LaBounty,Hug Your History Teacher,http://mitadmissions.org/blogs/entry/hug-your-history-teacher,639,2,1,6,9
Sep 10 2012,Rachel D. '16,World Suicide Prevention Day,http://mitadmissions.org/blogs/entry/world-suicide-prevention-day,640,0,0,0,0
Sep 10 2012,Connie H. '15,The Results of My Summer,http://mitadmissions.org/blogs/entry/the-results-of-my-summer,640,0,0,0,0
Sep 10 2012,Hamsika C. '13,In Which I Feel Old,http://mitadmissions.org/blogs/entry/in-which-i-feel-old,640,0,0,0,0
Sep 9 2012,Emad T. '14,Junior Year: The First Week,http://mitadmissions.org/blogs/entry/junior-year-the-first-week,641,0,0,0,0
Sep 7 2012,Jenny X. '13,"I came, I saw, I stirfried",http://mitadmissions.org/blogs/entry/i-came-i-saw,643,3,2,0,5
Sep 6 2012,Michael C. '16,"Eric Lander, spring rolls, and the New York Times",http://mitadmissions.org/blogs/entry/eric-lander-spring-rolls-and-the-new-york-times,644,4,0,0,4
Sep 6 2012,Anna H. '14,The last few days of summer,http://mitadmissions.org/blogs/entry/the-last-few-days-of-summer,644,0,0,0,0
Sep 4 2012,Kris Guay,MyMIT is live,http://mitadmissions.org/blogs/entry/mymit-is-live,646,5,3,0,8
Sep 4 2012,Natasha B. '16,The Hardest Thing Ever,http://mitadmissions.org/blogs/entry/the-hardest-thing-ever,646,3,2,0,5
Sep 3 2012,Rachel F. '12,Life After: A Collage,http://mitadmissions.org/blogs/entry/life-after-a-collage,647,2,1,0,3
Sep 3 2012,Gabe B. '13,Guest Post: Rush & Recruitment 2012,http://mitadmissions.org/blogs/entry/guest-post-rush-recruitment-2012,647,1,0,0,1
Aug 30 2012,Elizabeth C. '13,Sounds of Summer,http://mitadmissions.org/blogs/entry/sounds-of-summer,651,3,0,0,3
Aug 29 2012,Rachel D. '16,FUP!!!,http://mitadmissions.org/blogs/entry/fup,652,3,1,0,4
Aug 29 2012,Rachel D. '16,You Got The Gig,http://mitadmissions.org/blogs/entry/you-got-the-gig,652,10,3,0,13
Aug 28 2012,Anna H. '14,Associate Advising and the MedLinks Program,http://mitadmissions.org/blogs/entry/associate-advising-and-the-medlinks-program,653,2,0,0,2
Aug 28 2012,Michael C. '16,(beginnings,http://mitadmissions.org/blogs/entry/beginnings,653,3,1,0,4
Aug 27 2012,Anastassia B. '16,A FAPulous Start,http://mitadmissions.org/blogs/entry/a-fapulous-start,654,3,6,0,9
Aug 26 2012,Lydia K. '14,Random Hall REX!,http://mitadmissions.org/blogs/entry/random-hall-rex,655,1,1,0,2
Aug 25 2012,Natnael G. '15,[Guest Blog] CourseRoad!,http://mitadmissions.org/blogs/entry/guest-blog-courseroad,656,3,1,0,4
Aug 22 2012,Jenny X. '13,3 Things We Dont Remember Enough,http://mitadmissions.org/blogs/entry/3-things-we-dont-remember-enough,659,1,0,0,1
Aug 22 2012,Chris LaBounty,Chem Lab Boot Camp!,http://mitadmissions.org/blogs/entry/chem-lab-boot-camp,659,3,0,0,3
Aug 21 2012,Lydia K. '14,"Vlogging, Tweets, and a Riddle",http://mitadmissions.org/blogs/entry/vlog-fun,660,2,1,0,3
Aug 21 2012,Natnael G. '15,Life Update,http://mitadmissions.org/blogs/entry/Nats-Life-Update,660,1,1,0,2
Aug 21 2012,Anna H. '14,"Curiosity, Part 2",http://mitadmissions.org/blogs/entry/curiosity-part-2,660,6,1,0,7
Aug 20 2012,Beatriz Valdez,An MIT Adventure,http://mitadmissions.org/blogs/entry/an-mit-adventure,661,4,0,0,4
Aug 20 2012,Linh V.  '13,Summer Magic,http://mitadmissions.org/blogs/entry/Boston-summer,661,3,0,0,3
Aug 18 2012,Emad T. '14,Things You Wont Have to Buy (or spend *that* much on),http://mitadmissions.org/blogs/entry/things-you-wont-have-to-buy-or-spend-that-much-on,663,4,4,0,8
Aug 14 2012,Elizabeth C. '13,Summer Adventures in MO,http://mitadmissions.org/blogs/entry/summer-adventures-in-mo,667,5,0,0,5
Aug 14 2012,Kirsten L. '15 ,Invasion of the Stikmen,http://mitadmissions.org/blogs/entry/invasion-of-the-stikmen,667,3,1,0,4
Aug 10 2012,Jenny X. '13,Be yourself or create yourself?,http://mitadmissions.org/blogs/entry/being-yourself-or-creating-yourself,671,9,2,0,11
Aug 10 2012,Anna H. '14,Curiosity,http://mitadmissions.org/blogs/entry/curiosity,671,4,0,0,4
Aug 10 2012,Anna H. '14,My advisor won $3 million,http://mitadmissions.org/blogs/entry/my-advisor-won-3-million,671,3,0,0,3
Aug 7 2012,Chris LaBounty,"Dont worry, the king lives",http://mitadmissions.org/blogs/entry/the-king,674,4,0,0,4
Aug 6 2012,Chris Peterson,See You Later,http://mitadmissions.org/blogs/entry/see-you-later,675,8,3,6,17
Aug 6 2012,MISTI Program,Mussels and Brussels,http://mitadmissions.org/blogs/entry/mussels-and-brussels,675,7,2,0,9
Aug 5 2012,Lydia K. '14,Happy Valley and the Sandusky Scandal,http://mitadmissions.org/blogs/entry/happy-valley-and-the-sandusky-scandal1,676,7,1,4,12
Aug 4 2012,Connie H. '15,GTL,http://mitadmissions.org/blogs/entry/gtl,677,1,0,0,1
Aug 3 2012,Chris Peterson,Meet The (New) Bloggers!,http://mitadmissions.org/blogs/entry/meet-the-new-bloggers-2012,678,22,4,1,27
Aug 2 2012,Kirsten L. '15 ,How to Make a Flashlight,http://mitadmissions.org/blogs/entry/how-to-make-a-flashlight,679,0,1,3,4
Jul 31 2012,Snively '11,How to jump out of an airplane and live,http://mitadmissions.org/blogs/entry/how-to-jump-out-of-an-airplane-and-live,681,4,4,0,8
Jul 30 2012,Anna H. '14,Two Pulsar Discoveries,http://mitadmissions.org/blogs/entry/two-pulsar-discoveries,682,7,3,1,11
Jul 30 2012,Chris Peterson,How To Write A College Essay,http://mitadmissions.org/blogs/entry/how-to-write-a-college-essay,682,117,69,26,212
Jul 30 2012,MISTI Program,Total immersion,http://mitadmissions.org/blogs/entry/rachels-incredible-italian-inquisition,682,0,0,0,0
Jul 27 2012,Chris Peterson,danger!awesome,http://mitadmissions.org/blogs/entry/dangerawesome,685,2,0,0,2
Jul 26 2012,MISTI Program,Salut!,http://mitadmissions.org/blogs/entry/salut,686,0,3,0,3
Jul 26 2012,Natnael G. '15,Walter Lewin ESG Lecture,http://mitadmissions.org/blogs/entry/walter-lewin-esg-lecture,686,0,3,0,3
Jul 25 2012,Lydia K. '14,Giant Cows Eat Venus; Earth Next,http://mitadmissions.org/blogs/entry/giant-cows-eat-venus-earth-next,687,1,2,0,3
Jul 22 2012,Ana V. '15 ,Talk to Strangers,http://mitadmissions.org/blogs/entry/voices-kept-forever,690,2,2,0,4
Jul 20 2012,Kirsten L. '15 ,Adventures Out There.. in Boston!,http://mitadmissions.org/blogs/entry/adventures-out-there.....-in-boston,692,6,1,0,7
Jul 17 2012,MISTI Program,"Sunrise, Sunset",http://mitadmissions.org/blogs/entry/sunrise-sunset,695,13,2,1,16
Jul 17 2012,MISTI Program,Publishing abroad,http://mitadmissions.org/blogs/entry/publishing-abroad,695,2,1,1,4
Jul 17 2012,Jenny X. '13,Life Coming Full Circle,http://mitadmissions.org/blogs/entry/life-coming-full-circle,695,1,0,0,1
Jul 16 2012,Beatriz Valdez,MIT-Now in Espaol!,http://mitadmissions.org/blogs/entry/mit-now-in-espanol,696,1,0,0,1
Jul 15 2012,Anna H. '14,Two cakes and six cupcakes,http://mitadmissions.org/blogs/entry/two-cakes-and-six-cupcakes,697,4,2,0,6
Jul 15 2012,Hamsika C. '13,A Day in My Summer Life,http://mitadmissions.org/blogs/entry/a-day-in-my-summer-life,697,0,0,0,0
Jul 12 2012,Emad T. '14,What Trains Make Me Think Of,http://mitadmissions.org/blogs/entry/what-trains-make-me-think-of,700,1,0,0,1
Jul 11 2012,Anna H. '14,Im sitting at work right now,http://mitadmissions.org/blogs/entry/im-sitting-at-work-right-now,701,0,0,0,0
Jul 11 2012,Chris Peterson,A Moment with A Minister,http://mitadmissions.org/blogs/entry/a-moment-with-a-minister,701,11,3,4,18
Jul 10 2012,MISTI Program,Language (die Sprache),http://mitadmissions.org/blogs/entry/language-die-sprache,702,0,5,0,5
Jul 10 2012,Gabe B. '13,Get to know Tim the Beaver!,http://mitadmissions.org/blogs/entry/get-to-know-tim-the-beaver,702,6,0,0,6
Jul 10 2012,Anna H. '14,The Publics Biggest Fear,http://mitadmissions.org/blogs/entry/the-publics-biggest-fear,702,3,1,0,4
Jul 10 2012,Lydia K. '14,Random Hall Rooms,http://mitadmissions.org/blogs/entry/random-hall-rooms,702,2,5,0,7
Jul 9 2012,Chris Peterson,Blogger Application 2012!,http://mitadmissions.org/blogs/entry/blogger-application-2012,703,6,7,1,14
Jul 8 2012,Linh V.  '13,The end of a chapter,http://mitadmissions.org/blogs/entry/the-end-of-a-chapter,704,0,6,0,6
Jun 27 2012,Anna H. '14,Up,http://mitadmissions.org/blogs/entry/up,715,1,0,0,1
Jun 25 2012,Chris Peterson,Just To Be Clear: We Dont Do Legacy,http://mitadmissions.org/blogs/entry/just-to-be-clear-we-dont-do-legacy,717,40,22,3,65
Jun 25 2012,Jess K. '10,Advice From The Elderly,http://mitadmissions.org/blogs/entry/advice-from-the-elderly,717,56,10,10,76
Jun 24 2012,Maggie L. '12,IntroducingStan!,http://mitadmissions.org/blogs/entry/introducing...stan,718,3,0,0,3
Jun 22 2012,Anna H. '14,13/101 Things To Do Before You Graduate,http://mitadmissions.org/blogs/entry/icing-skate,720,3,2,0,5
Jun 18 2012,Jess K. '10,Rambax MIT Goes To Senegal,http://mitadmissions.org/blogs/entry/rambax-mit-goes-to-senegal,724,3,1,0,4
Jun 17 2012,ARTalk,Youre Not That Old,http://mitadmissions.org/blogs/entry/youre-not-that-old,725,9,1,3,13
Jun 13 2012,Rachel F. '12,The Last All-Nighter,http://mitadmissions.org/blogs/entry/the-last-all-nighter,729,3,5,13,21
Jun 12 2012,Chris Peterson,From Markets to Math Class,http://mitadmissions.org/blogs/entry/from-markets-to-math-class,730,4,2,0,6
Jun 9 2012,Jenny X. '13,A Plot Twist,http://mitadmissions.org/blogs/entry/a-plot-twist,733,3,1,0,4
Jun 9 2012,Emad T. '14,Just Run With It,http://mitadmissions.org/blogs/entry/just-run-with-it,733,3,0,0,3
Jun 8 2012,Snively '11,Kick . . .,http://mitadmissions.org/blogs/entry/kick,734,6,0,0,6
Jun 8 2012,Chris Peterson,The Wisdom of Khan,http://mitadmissions.org/blogs/entry/the-wisdom-of-khan,734,39,10,11,60
Jun 8 2012,Maggie L. '12,Take Only Memories,http://mitadmissions.org/blogs/entry/take-only-memories,734,15,2,4,21
Jun 8 2012,Rachel F. '12,"Graduation, Livestreamed",http://mitadmissions.org/blogs/entry/graduation-livestreamed,734,1,0,0,1
Jun 6 2012,Kim Hunter '86,Time Flies,http://mitadmissions.org/blogs/entry/time-flies,736,33,7,8,48
Jun 6 2012,Susan Sullivan,Summer To-Do List from Student Financial Services,http://mitadmissions.org/blogs/entry/summer-to-do-list-from-student-financial-services,736,1,1,0,2
Jun 5 2012,Chris Peterson,Fortune Favors,http://mitadmissions.org/blogs/entry/fortune-favors,737,17,10,6,33
Jun 5 2012,Maggie L. '12,The story behind TIMtalks,http://mitadmissions.org/blogs/entry/the-story-behind-timtalks,737,6,1,2,9
Jun 1 2012,Chris S. '11,"Three Guys, Six Degrees",http://mitadmissions.org/blogs/entry/three-guys-six-degrees,741,7,2,4,13
May 30 2012,Elizabeth C. '13,The Best Advice I Ever Got,http://mitadmissions.org/blogs/entry/the-best-advice-i-ever-got,743,208,99,54,361
May 25 2012,Kirsten L. '15 ,Another Toy Story,http://mitadmissions.org/blogs/entry/another-toy-story,748,20,5,6,31
May 24 2012,Maggie L. '12,Breadsticks and Business,http://mitadmissions.org/blogs/entry/breadsticks-and-business,749,4,2,0,6
May 21 2012,Rachel F. '12,rolltreppe,http://mitadmissions.org/blogs/entry/rolltreppe,752,7,2,4,13
May 20 2012,Emad T. '14,Delivery!,http://mitadmissions.org/blogs/entry/delivery-exclamation-point,753,6,5,3,14
May 19 2012,Chris Peterson,Tim Is So Beautiful,http://mitadmissions.org/blogs/entry/tim-is-so-beautiful,754,3,2,0,5
May 13 2012,Anna H. '14,Urinetown,http://mitadmissions.org/blogs/entry/urinetown,760,3,3,4,10
May 13 2012,Connie H. '15,Quad Life,http://mitadmissions.org/blogs/entry/quad-life,760,2,0,0,2
May 7 2012,Emad T. '14,Underneath All That Polish,http://mitadmissions.org/blogs/entry/underneath-all-that-polish,766,2,2,0,4
May 6 2012,Ana V. '15 ,Current State of Mind,http://mitadmissions.org/blogs/entry/current-state-of-mind,767,3,1,0,4
May 5 2012,Jenny X. '13,Bibliophiles assemble!,http://mitadmissions.org/blogs/entry/bibliophiles-assemble,768,2,0,0,2
May 4 2012,Mikey Yang '05,Waitlist Decisions 2012,http://mitadmissions.org/blogs/entry/waitlist-decisions-2012,769,40,25,49,114
May 1 2012,Chris Peterson,MIT Imagination,http://mitadmissions.org/blogs/entry/mit-imagination,772,81,47,86,214
Apr 30 2012,Stu Schmill '86,"Stephen, Im Putting You On Notice!",http://mitadmissions.org/blogs/entry/stephen-im-putting-you-on-notice,773,1090,561,282,1933
Apr 30 2012,Chris M. '12,A couple of hacks from a couple of hacks,http://mitadmissions.org/blogs/entry/a-couple-of-hacks-from-a-couple-of-hacks,773,29,12,9,50
Apr 29 2012,Lydia K. '14,Why I Chose MIT,http://mitadmissions.org/blogs/entry/why-i-chose-mit,774,16,9,2,27
Apr 28 2012,Hamsika C. '13,Pre-Med @ MIT,http://mitadmissions.org/blogs/entry/pre-med-mit,775,10,5,3,18
Apr 26 2012,Qiaochu Y. '12,"Decisions, Decisions",http://mitadmissions.org/blogs/entry/decisions-decisions,777,13,4,7,24
Apr 23 2012,Stu Schmill '86,A Few Lessons from FLL,http://mitadmissions.org/blogs/entry/a-few-lessons-from-fll,780,18,8,9,35
Apr 20 2012,Linh V.  '13,90-something days of summer (Part 1),http://mitadmissions.org/blogs/entry/90-something-days-of-summer,783,7,2,0,9
Apr 19 2012,Lydia K. '14,A Random [Hall] Sophomores Guide to CPW,http://mitadmissions.org/blogs/entry/a-random-hall-sophomores-guide-to-cpw,784,4,1,0,5
Apr 18 2012,Rachel F. '12,The CPW Weather Machine Strikes Again,http://mitadmissions.org/blogs/entry/the-cpw-weather-machine-strikes-again,785,4,1,0,5
Apr 18 2012,Natnael G. '15,16 for the 16s,http://mitadmissions.org/blogs/entry/16-for-the-16s,785,24,7,25,56
Apr 18 2012,Elizabeth C. '13,DDR Tetris,http://mitadmissions.org/blogs/entry/ddr-tetris,785,4,1,1,6
Apr 17 2012,Maggie L. '12,Simulating Catastrophe,http://mitadmissions.org/blogs/entry/simulating-catastrophe,786,0,0,0,0
Apr 17 2012,Keri G. '10,11 Reasons Why Senior Haus is Awesome,http://mitadmissions.org/blogs/entry/11-reasons-why-senior-haus-is-awesome,786,10,3,3,16
Apr 17 2012,Jenny X. '13,Attention local high school students interested science and engineering!,http://mitadmissions.org/blogs/entry/attention-local-high-school-students-interested-science-and-engineering,786,5,4,5,14
Apr 15 2012,Kim Hunter '86,How to CPW 2012a Guide for Parents,http://mitadmissions.org/blogs/entry/how-to-cpw-2012a-guide-for-parents,788,5,3,3,11
Apr 11 2012,Chris Peterson,Caines Arcade,http://mitadmissions.org/blogs/entry/caines-arcade,792,4,3,0,7
Apr 8 2012,Elizabeth C. '13,In which Elizabeth tries something new.,http://mitadmissions.org/blogs/entry/in-which-elizabeth-tries-something-new,795,6,3,3,12
Apr 7 2012,Lydia K. '14,Dyslexia at MIT,http://mitadmissions.org/blogs/entry/dyslexia-at-mit1,796,90,45,17,152
Apr 6 2012,Chris Peterson,The Minerva Delusion,http://mitadmissions.org/blogs/entry/the-minerva-delusion,797,32,34,40,106
Apr 5 2012,Rachel F. '12,Telethon FAQs,http://mitadmissions.org/blogs/entry/telethon-faqs,798,3,0,0,3
Apr 3 2012,Chris Peterson,Transfer Decisions Released Today,http://mitadmissions.org/blogs/entry/transfer-decisions-released-today,800,3,3,2,8
Apr 3 2012,Lydia K. '14,The Bubble Bath Disastrophe (and Other Adventures),http://mitadmissions.org/blogs/entry/the-bubble-bath-disastrophe-and-other-adventures,800,3,2,0,5
Apr 2 2012,Jenny X. '13,Vmonos!,http://mitadmissions.org/blogs/entry/vamonos,801,1,1,0,2
Apr 2 2012,Elizabeth C. '13,Its like I go to class or something.,http://mitadmissions.org/blogs/entry/its-like-i-go-to-class-or-something,801,0,1,0,1
Apr 1 2012,Ana V. '15 ,Analogies,http://mitadmissions.org/blogs/entry/analogies,802,1,0,0,1
Mar 31 2012,Hamsika C. '13,Spring Break,http://mitadmissions.org/blogs/entry/spring-break,803,3,1,0,4
Mar 30 2012,Natnael G. '15,"21W.021 - MIT 150: Inside, Live",http://mitadmissions.org/blogs/entry/21w.021-mit-150-inside-live,804,3,1,1,5
Mar 30 2012,David duKor-Jackson,The Perfect Match?,http://mitadmissions.org/blogs/entry/the-perfect-match,804,1,0,0,1
Mar 29 2012,Chris Peterson,Kickstart My Art,http://mitadmissions.org/blogs/entry/kickstart-my-art,805,2,0,0,2
Mar 28 2012,Beatriz Valdez,A New England Spring,http://mitadmissions.org/blogs/entry/a-new-england-spring,806,1,0,0,1
Mar 27 2012,Chris Peterson,The Real Deal,http://mitadmissions.org/blogs/entry/the-real-deal,807,64,25,18,107
Mar 26 2012,David duKor-Jackson,Holding out for a piece of Pi,http://mitadmissions.org/blogs/entry/holding-out-for-a-piece-of-pi,808,4,0,0,4
Mar 25 2012,Anna H. '14,"Classes, musicals, teaching, research, sports, and wisdom tooth surgery.",http://mitadmissions.org/blogs/entry/classes-musicals-teaching-research-sports-and-wisdom-tooth-surgery,809,2,1,2,5
Mar 25 2012,Kirsten L. '15 ,Why So Serious?,http://mitadmissions.org/blogs/entry/why-so-serious,809,17,7,5,29
Mar 23 2012,Kris Guay,Free Lunch,http://mitadmissions.org/blogs/entry/free-lunch,811,3,1,2,6
Mar 22 2012,Hamsika C. '13,A Field Trip,http://mitadmissions.org/blogs/entry/a-field-trip1,812,4,2,0,6
Mar 21 2012,Kris Guay,Admitted Student Gatherings,http://mitadmissions.org/blogs/entry/admitted-student-gatherings,813,3,0,0,3
Mar 20 2012,ARTalk,Gotterdammerung and The Barber of Seville,http://mitadmissions.org/blogs/entry/gotterdammerung-and-the-barber-of-seville,814,0,0,0,0
Mar 18 2012,Ana V. '15 ,Over is the Wait,http://mitadmissions.org/blogs/entry/over-is-the-wait,816,13,4,6,23
Mar 16 2012,Susan Sullivan,After the Award Letter,http://mitadmissions.org/blogs/entry/after-the-award-letter,818,2,3,0,5
Mar 15 2012,Matt McGann '00,More for Admitted Students,http://mitadmissions.org/blogs/entry/more-for-admitted-students,819,1,2,0,3
Mar 15 2012,Matt McGann '00,Waitlist FAQ,http://mitadmissions.org/blogs/entry/waitlist-faq,819,2,5,2,9
Mar 14 2012,Chris Peterson,MIT Regular Action Decisions Now Available Online,http://mitadmissions.org/blogs/entry/mit-regular-action-decisions-now-available-online,820,8,4,3,15
Mar 14 2012,Decisions,Open Thread: Admitted,http://mitadmissions.org/blogs/entry/open-thread-admitted,820,9,1,0,10
Mar 14 2012,Decisions,Open Thread: Waitlisted,http://mitadmissions.org/blogs/entry/open-thread-waitlisted,820,5,0,0,5
Mar 14 2012,Decisions,Open Thread: Not Admitted,http://mitadmissions.org/blogs/entry/open-thread-not-admitted,820,4,7,0,11
Mar 14 2012,Elizabeth C. '13,Important,http://mitadmissions.org/blogs/entry/important,820,102,30,26,158
Mar 13 2012,David duKor-Jackson,To whom much is given,http://mitadmissions.org/blogs/entry/to-whom-much-is-given,821,13,4,1,18
Mar 13 2012,Matt McGann '00,"Pi Day, Tau Time",http://mitadmissions.org/blogs/entry/pi-day-tau-time,821,59,67,22,148
Mar 12 2012,MISTI Program,The Last Day at Gymnasium Untergriesbach,http://mitadmissions.org/blogs/entry/the-last-day-at-gymnasium-untergriesbach,822,1,2,0,3
Mar 12 2012,Linh V.  '13,Defying Gravity,http://mitadmissions.org/blogs/entry/defying-gravity,822,1,0,0,1
Mar 10 2012,Chris Peterson,Discuss Disqus,http://mitadmissions.org/blogs/entry/discuss-disqus,824,8,2,0,10
Mar 10 2012,Anna H. '14,FIRST Robotics and Alumna-hood,http://mitadmissions.org/blogs/entry/first-robotics-and-alumna-hood,824,8,12,1,21
Mar 9 2012,Rachel F. '12,Photodiary,http://mitadmissions.org/blogs/entry/photodiary,825,9,2,0,11
Mar 8 2012,Lydia K. '14,As We Approach Decision Day,http://mitadmissions.org/blogs/entry/as-we-approach-decision-day1,826,12,7,1,20
Mar 8 2012,Susan Sullivan,The wait is almost over,http://mitadmissions.org/blogs/entry/the-wait-is-almost-over,826,4,4,0,8
Mar 7 2012,Sir Nigel Blogberry,I have SMASHING news!,http://mitadmissions.org/blogs/entry/i-have-smashing-news,827,55,213,9,277
Mar 6 2012,Gabe B. '13,Sigma ChIgloo,http://mitadmissions.org/blogs/entry/sigma-chigloo,828,0,2,0,2
Mar 3 2012,Anna H. '14,Watching Birdwatchers,http://mitadmissions.org/blogs/entry/watching-birdwatchers,831,0,2,0,2
Mar 3 2012,Lydia K. '14,Whats my age again?,http://mitadmissions.org/blogs/entry/whats-my-age-again,831,0,2,0,2
Mar 2 2012,Chris M. '12,Snow!,http://mitadmissions.org/blogs/entry/whats-there-to-do-for-fun-around-here,832,0,1,0,1
Feb 29 2012,Kris Guay,Weekend in Kendall Square,http://mitadmissions.org/blogs/entry/weekend-in-kendall-square,834,0,0,0,0
Feb 29 2012,Hamsika C. '13,"Heck yeah, democracy.",http://mitadmissions.org/blogs/entry/i-love-it-when-things-like-this-happen,834,0,1,0,1
Feb 29 2012,Gabe B. '13,MIT is just another place,http://mitadmissions.org/blogs/entry/mit-is-just-another-place,834,4,7,0,11
Feb 28 2012,Rachel F. '12,Free-est post!,http://mitadmissions.org/blogs/entry/free-est-post,835,0,0,0,0
Feb 27 2012,Elizabeth C. '13,Dinner With Goobers,http://mitadmissions.org/blogs/entry/dinner-with-goobers,836,0,0,0,0
Feb 27 2012,Natnael G. '15,"Pass No Record, Oh How I Loved Thee.",http://mitadmissions.org/blogs/entry/pass-no-record-oh-how-i-loved-thee,836,0,4,0,4
Feb 25 2012,Susan Sullivan,"Deadlines, Paperwork and Your Financial Aid",http://mitadmissions.org/blogs/entry/deadlines-paperwork-and-your-financial-aid1,838,2,2,0,4
Feb 21 2012,Jenny X. '13,Its like finding candy in your pocket,http://mitadmissions.org/blogs/entry/its-like-finding-candy-in-your-pocket,842,0,0,0,0
Feb 21 2012,Chris M. '12,TERMinal Velocity,http://mitadmissions.org/blogs/entry/terminal-velocity,842,0,0,0,0
Feb 19 2012,Rachel F. '12,Techfair!,http://mitadmissions.org/blogs/entry/techfair,844,0,10,0,10
Feb 18 2012,Hamsika C. '13,Cancer,http://mitadmissions.org/blogs/entry/cancer,845,0,0,0,0
Feb 17 2012,Emad T. '14,High Class Brass,http://mitadmissions.org/blogs/entry/high-class-brass,846,0,1,0,1
Feb 17 2012,Chris Peterson,The Making of a Mystery,http://mitadmissions.org/blogs/entry/anatomy-of-a-mystery,846,0,0,0,0
Feb 16 2012,Ana V. '15 ,Ode to the Institute,http://mitadmissions.org/blogs/entry/because-it-really-deserves-some-love,847,0,1,0,1
Feb 16 2012,Linh V.  '13,Travelogue: Part Une,http://mitadmissions.org/blogs/entry/travelogue-part-une,847,0,3,0,3
Feb 15 2012,Gabe B. '13,16.810 Rapid Design and Prototyping,http://mitadmissions.org/blogs/entry/16.810-rapid-design-and-prototyping,848,0,2,0,2
Feb 15 2012,Rachel F. '12,MacGyvering Bacon-tines Day,http://mitadmissions.org/blogs/entry/macgyvering-bacon-tines-day,848,0,2,0,2
Feb 15 2012,Lydia K. '14,Computers and their Programs,http://mitadmissions.org/blogs/entry/computers-and-their-programs1,848,4,7,0,11
Feb 14 2012,Kirsten L. '15 ,Why I Love MIT,http://mitadmissions.org/blogs/entry/why-i-love-mit,849,1,2,0,3
Feb 12 2012,Hamsika C. '13,Guest Entry: Stephanie Lin,http://mitadmissions.org/blogs/entry/guest-entry-stephanie-lin,851,0,2,0,2
Feb 10 2012,Maggie L. '12,Pics or it didnt happen?,http://mitadmissions.org/blogs/entry/pics-or-it-didnt-happen,853,0,0,0,0
Feb 9 2012,Hamsika C. '13,Filled With Cute Babies,http://mitadmissions.org/blogs/entry/filled-with-cute-babies,854,0,2,0,2
Feb 9 2012,MISTI Program,MIT-India student interns at the Tata Institute of Fundamental Research,http://mitadmissions.org/blogs/entry/mit-india-student-interns-at-the-tata-institute-of-fundamental-re,854,0,0,0,0
Feb 9 2012,Linh V.  '13,New kid on the block,http://mitadmissions.org/blogs/entry/new-kid-on-the-block1,854,0,3,0,3
Feb 9 2012,Ana V. '15 ,IAP=Watermelon in January,http://mitadmissions.org/blogs/entry/how-is-it-already-february,854,0,2,0,2
Feb 8 2012,Qiaochu Y. '12,The Cloud,http://mitadmissions.org/blogs/entry/the-cloud,855,0,0,0,0
Feb 7 2012,Kris Guay,Our new video,http://mitadmissions.org/blogs/entry/our-new-video,856,9,6,0,15
Feb 7 2012,Jenny X. '13,The Way We Live,http://mitadmissions.org/blogs/entry/the-way-we-live,856,0,0,0,0
Feb 5 2012,Rachel F. '12,"For the love of 6.470, Montresor",http://mitadmissions.org/blogs/entry/for-the-love-of-6470-montresor,858,1,3,0,4
Feb 4 2012,Maggie L. '12,MIT Can Talk!,http://mitadmissions.org/blogs/entry/mit-can-talk,859,0,1,0,1
Feb 4 2012,Hamsika C. '13,Fun Times @ MIT (Pt. 1),http://mitadmissions.org/blogs/entry/fun-times-mit-pt.-1,859,0,1,0,1
Feb 1 2012,Connie H. '15,TELETHONNNNN,http://mitadmissions.org/blogs/entry/telethonnnnn,862,0,5,0,5
Feb 1 2012,Elizabeth C. '13,Are You Stressed?,http://mitadmissions.org/blogs/entry/are-you-stressed,862,2,7,2,11
Feb 1 2012,Matt McGann '00,The MIT Midyear Report,http://mitadmissions.org/blogs/entry/the-mit-midyear-report,862,1,4,0,5
Jan 30 2012,Chris Peterson,Missing Document Deadline Extended to Wednesday,http://mitadmissions.org/blogs/entry/missing-document-deadline-extended-to-wednesday,864,1,1,0,2
Jan 28 2012,OEL,Greetings from India: D-Lab Students in the Field,http://mitadmissions.org/blogs/entry/greetings-from-india-d-lab-cycle-ventures-in-the-field,866,2,3,1,6
Jan 28 2012,Qiaochu Y. '12,Things That Have Happened To Me Recently,http://mitadmissions.org/blogs/entry/things-that-have-happened-to-me-recently,866,0,0,0,0
Jan 27 2012,Hamsika C. '13,LeaderShape 2012,http://mitadmissions.org/blogs/entry/leadershape-2012,867,0,0,0,0
Jan 27 2012,Piper '13,Space Robots II: Attack of the Paradigm Shifts,http://mitadmissions.org/blogs/entry/space-robots-ii,867,0,2,0,2
Jan 26 2012,Elizabeth C. '13,Grown Up,http://mitadmissions.org/blogs/entry/grown-up,868,5,20,0,25
Jan 26 2012,Chris Peterson,Missing Documents Due Monday,http://mitadmissions.org/blogs/entry/missing-documents-due-monday,868,0,1,0,1
Jan 25 2012,OEL,Greetings from Cambodia: D-Lab students in the field,http://mitadmissions.org/blogs/entry/greetings-from-cambodia-d-lab-students-in-the-field,869,0,7,0,7
Jan 25 2012,Kirsten L. '15 ,Everyday Im Trufflin,http://mitadmissions.org/blogs/entry/everyday-im-trufflin,869,0,2,0,2
Jan 24 2012,Anna H. '14,Lets do a puzzle.,http://mitadmissions.org/blogs/entry/lets-do-a-puzzle,870,0,1,0,1
Jan 24 2012,Lydia K. '14,Needles,http://mitadmissions.org/blogs/entry/needles,870,0,1,0,1
Jan 23 2012,Kirsten L. '15 ,Bad Ideas,http://mitadmissions.org/blogs/entry/bad-ideas,871,0,3,0,3
Jan 23 2012,Chris M. '12,MIT Outing Club: Ice Climbing,http://mitadmissions.org/blogs/entry/mit-outing-club-ice-climbing,871,0,0,0,0
Jan 22 2012,Rachel F. '12,An Afternoon In/Out Of The Snow,http://mitadmissions.org/blogs/entry/an-afternoon-in-out-of-the-snow,872,0,1,0,1
Jan 21 2012,Connie H. '15,"Rebecca Black, the Old Spice Guy, and How to Sell Staplers",http://mitadmissions.org/blogs/entry/rebecca-black-the-old-spice-guy-and-how-to-sell-staplers,873,0,0,0,0
Jan 20 2012,Lydia K. '14,"Views of Campus, the Charles River, and the First Snow",http://mitadmissions.org/blogs/entry/panoramas-of-campus-the-charles-river-and-the-first-snow,874,0,15,0,15
Jan 19 2012,Elizabeth C. '13,"624 Hours: Columbia, MO",http://mitadmissions.org/blogs/entry/624-hours-in-columbia,875,0,1,0,1
Jan 19 2012,Natnael G. '15,Rebound Rumble!,http://mitadmissions.org/blogs/entry/rebound-rumble,875,0,2,0,2
Jan 19 2012,Matt McGann '00,Regular Action Update,http://mitadmissions.org/blogs/entry/regular-action-update,875,0,0,0,0
Jan 18 2012,OEL,Greetings from Honduras: D-Lab students in the field,http://mitadmissions.org/blogs/entry/greetings-from-honduras-d-lab-students-in-the-field,876,0,3,0,3
Jan 18 2012,Chris Peterson,Why We Blacked Out The Blogs,http://mitadmissions.org/blogs/entry/why-we-blacked-out-the-blogs,876,0,86,0,86
Jan 15 2012,Emad T. '14,Grades in Context,http://mitadmissions.org/blogs/entry/grades-in-context,879,1,3,0,4
Jan 15 2012,Kirsten L. '15 ,"H^3: Home, Hummus, and HBV",http://mitadmissions.org/blogs/entry/h3-home-hummus-and-HBV,879,0,5,0,5
Jan 14 2012,Chris M. '12,IAP: Its Amazing Pterodactyl,http://mitadmissions.org/blogs/entry/iap-its-amazing-pterodactyl,880,0,2,0,2
Jan 11 2012,Jenny X. '13,Starting 2012 on a volcanic island,http://mitadmissions.org/blogs/entry/starting-2012-on-a-volcanic-island,883,0,1,0,1
Jan 10 2012,Rachel F. '12,One Wheel To Rule Them All,http://mitadmissions.org/blogs/entry/one-wheel-to-rule-them-all,884,4,11,2,17
Jan 9 2012,ARTalk,World of Wires,http://mitadmissions.org/blogs/entry/world-of-wires1,885,0,0,0,0
Jan 9 2012,David duKor-Jackson,The Trouble with External Validation,http://mitadmissions.org/blogs/entry/the-trouble-with-external-validation,885,5,3,0,8
Jan 5 2012,Gabe B. '13,One Thing I Love About MIT,http://mitadmissions.org/blogs/entry/following-leads,889,0,1,0,1
Jan 5 2012,Snively '11,Surviving MIT,http://mitadmissions.org/blogs/entry/surviving-mit,889,168,147,58,373
Jan 4 2012,Matt McGann '00,Missing documents!,http://mitadmissions.org/blogs/entry/missing-documents,890,0,2,0,2
Jan 4 2012,Natnael G. '15,21 Reasons to Join ESG,http://mitadmissions.org/blogs/entry/21-reasons-to-join-esg,890,0,1,0,1
Jan 3 2012,Chris Peterson,Happy New Year!,http://mitadmissions.org/blogs/entry/happy-new-year,891,0,0,0,0
Jan 3 2012,Ana V. '15 ,Terrascope,http://mitadmissions.org/blogs/entry/terrorscope,891,0,3,0,3
Dec 29 2011,Qiaochu Y. '12,Ask Me Anything,http://mitadmissions.org/blogs/entry/ask-me-anything1,896,0,2,0,2
Dec 25 2011,Jenny X. '13,Impulsive Decisions,http://mitadmissions.org/blogs/entry/impulsive-decisions,900,0,0,0,0
Dec 22 2011,Matt McGann '00,Regular Action Deadline Q & A,http://mitadmissions.org/blogs/entry/regular-action-deadline-q-a,903,2,3,0,5
Dec 22 2011,Matt McGann '00,Deferred Applicants Q & A,http://mitadmissions.org/blogs/entry/deferred-applicants-q-a,903,0,0,0,0
Dec 22 2011,Kris Guay,The Year in Review,http://mitadmissions.org/blogs/entry/the-year-in-review,903,0,0,0,0
Dec 21 2011,Rachel F. '12,At The Ends Of Tunnels,http://mitadmissions.org/blogs/entry/at-the-ends-of-tunnels,904,6,3,5,14
Dec 21 2011,Hamsika C. '13,Disappointment,http://mitadmissions.org/blogs/entry/disappointment,904,10,2,2,14
Dec 21 2011,Elizabeth C. '13,Whats on a desk?,http://mitadmissions.org/blogs/entry/whats-on-a-desk,904,2,2,0,4
Dec 17 2011,Chris Peterson,MIT Early Action Decisions Now Available Online,http://mitadmissions.org/blogs/entry/mit-early-action-decisions-now-available-online,908,3,4,2,9
Dec 17 2011,Decisions,Open Thread: Admitted in Early Action.,http://mitadmissions.org/blogs/entry/open-thread-admitted1,908,2,1,0,3
Dec 17 2011,Decisions,Open Thread: EA Deferred,http://mitadmissions.org/blogs/entry/open-thread-ea-deferred,908,1,2,0,3
Dec 17 2011,Decisions,Open Thread: EA Not Admitted,http://mitadmissions.org/blogs/entry/open-thread-ea-not-admitted,908,0,2,5,7
Dec 17 2011,Anna H. '14,Youre stressed.,http://mitadmissions.org/blogs/entry/youre-stressed,908,1,1,1,3
Dec 16 2011,Chris Peterson,"Remember, Remember, the 17th of December",http://mitadmissions.org/blogs/entry/remember-remember-the-17th-of-december,909,4,4,2,10
Dec 15 2011,Chris Peterson,"Transfer Admissions Released Next Wednesday, 12/21",http://mitadmissions.org/blogs/entry/transfer-admissions-released-next-wednesday-12-21,910,0,1,1,2
Dec 14 2011,Maggie L. '12,Why did the engineer cross the road?,http://mitadmissions.org/blogs/entry/why-did-the-engineer-cross-the-road,911,2,3,1,6
Dec 14 2011,Chris Peterson,Invasion MIT!,http://mitadmissions.org/blogs/entry/mit-is-invaded,911,635,368,233,1236
Dec 13 2011,Tom R. '14,Home is Where the Heart is,http://mitadmissions.org/blogs/entry/home-is-where-the-heart-is,912,12,2,3,17
Dec 12 2011,Chris Peterson,"MIT EA Decisions To Be Posted Saturday, 12/17, at 12:17 PM EST",http://mitadmissions.org/blogs/entry/mit-ea-decisions-to-be-posted-saturday-12-17-at-1217-pm-est,913,34,16,58,108
Dec 12 2011,Lydia K. '14,Adventures with Miracle Fruit,http://mitadmissions.org/blogs/entry/adventures-with-miracle-fruit,913,8,5,7,20
Dec 10 2011,Hamsika C. '13,Two Videos,http://mitadmissions.org/blogs/entry/two-videos,915,7,3,1,11
Dec 9 2011,Elizabeth C. '13,9000 Words,http://mitadmissions.org/blogs/entry/9000-words,916,14,3,2,19
Dec 8 2011,Chris M. '12,The Complexity of Simplicity,http://mitadmissions.org/blogs/entry/the-complexity-of-simpliciyy,917,14,3,0,17
Dec 8 2011,Maggie L. '12,Lesson Planning,http://mitadmissions.org/blogs/entry/lesson-planning2,917,0,1,0,1
Dec 7 2011,MISTI Program,The POWER of a Mechanical Engineering,http://mitadmissions.org/blogs/entry/the-power-of-a-mechanical-engineering,918,4,2,0,6
Dec 4 2011,Jenny X. '13,The Post-MIT Trajectory,http://mitadmissions.org/blogs/entry/the-post-mit-trajectory,921,5,1,5,11
Dec 2 2011,Anna H. '14,I auditioned for a musical,http://mitadmissions.org/blogs/entry/i-auditioned-for-a-musical,923,5,1,16,22
Dec 1 2011,Gabe B. '13,Id Like Your Help With My Letter to President Obama,http://mitadmissions.org/blogs/entry/id-like-your-help-with-my-letter-to-president-obama,924,4,3,1,8
Nov 30 2011,Chris Peterson,Flourish and Blogs,http://mitadmissions.org/blogs/entry/flourish-and-blogs,925,4,9,20,33
Nov 30 2011,MISTI Program,Manage Your Future,http://mitadmissions.org/blogs/entry/manage-your-future,925,1,5,0,6
Nov 29 2011,Natnael G. '15,"Classes and Casting and Birthdays, oh my!",http://mitadmissions.org/blogs/entry/classes-and-casting-and-birthdays-oh-my,926,3,3,2,8
Nov 28 2011,ARTalk,Film!,http://mitadmissions.org/blogs/entry/film,927,0,0,0,0
Nov 27 2011,Anna H. '14,Big Questions and Small Scientists,http://mitadmissions.org/blogs/entry/big-questions-and-small-scientists,928,2,2,2,6
Nov 24 2011,ARTalk,Making Your Dorm Room a Piece of Art!,http://mitadmissions.org/blogs/entry/making-your-dorm-room-a-piece-of-art1,931,24,3,26,53
Nov 24 2011,Emad T. '14,The Curiosity Instinct,http://mitadmissions.org/blogs/entry/the-curiosity-instinct,931,5,2,9,16
Nov 23 2011,Maggie L. '12,"ICE, ICE baby",http://mitadmissions.org/blogs/entry/ice-ice-baby1,932,16,4,6,26
Nov 21 2011,MISTI Program,Architecture students,http://mitadmissions.org/blogs/entry/architecture-students,934,1,1,3,5
Nov 21 2011,Beatriz Valdez,Comfort and College,http://mitadmissions.org/blogs/entry/comfort-and-college,934,0,0,0,0
Nov 20 2011,Chris Peterson,The Month of Novembeard,http://mitadmissions.org/blogs/entry/the-month-of-novembeard,935,3,3,17,23
Nov 19 2011,Ana V. '15 ,Splish Splash,http://mitadmissions.org/blogs/entry/splish-splash,936,2,3,1,6
Nov 17 2011,Hamsika C. '13,Updates,http://mitadmissions.org/blogs/entry/updates,938,0,1,2,3
Nov 17 2011,MISTI Program,Break New Ground,http://mitadmissions.org/blogs/entry/break-new-ground,938,0,0,0,0
Nov 16 2011,Kirsten L. '15 ,Average,http://mitadmissions.org/blogs/entry/average,939,0,1,0,1
Nov 16 2011,MISTI Program,Labs throughout the world open their doors to MIT Biology students,http://mitadmissions.org/blogs/entry/labs-throughout-the-world-open-their-doors-to-mit-biology-students,939,4,1,0,5
Nov 15 2011,Chris Peterson,Important EA Processing Update!,http://mitadmissions.org/blogs/entry/important-ea-processing-update,940,0,3,0,3
Nov 15 2011,Anna H. '14,Halloween is the best day of the year.,http://mitadmissions.org/blogs/entry/halloween-is-the-best-day-of-the-year,940,0,0,0,0
Nov 14 2011,Qiaochu Y. '12,What Should I Do Next Semester?,http://mitadmissions.org/blogs/entry/what-should-i-do-next-semester,941,2,3,3,8
Nov 14 2011,Elizabeth C. '13,Mark Zuckerberg Visits MIT,http://mitadmissions.org/blogs/entry/mark-zuckerberg-visits-mit,941,3,2,0,5
Nov 14 2011,Chris Peterson,An Awesome Autobiography,http://mitadmissions.org/blogs/entry/a-touching-autobiography,941,0,6,2,8
Nov 12 2011,Jenny X. '13,We are artists & writers,http://mitadmissions.org/blogs/entry/we-are-artists-writers,943,17,7,2,26
Nov 11 2011,Chris Peterson,Deep Breath,http://mitadmissions.org/blogs/entry/deep-breath,944,0,2,0,2
Nov 9 2011,Gabe B. '13,Multidimensional,http://mitadmissions.org/blogs/entry/multidimensional,946,37,10,21,68
Nov 7 2011,ARTalk,Melancholia,http://mitadmissions.org/blogs/entry/melancholia,948,2,1,5,8
Nov 7 2011,Chris Peterson,(K)onstantly not good enough,http://mitadmissions.org/blogs/entry/konstantly-not-good-enough,948,0,2,0,2
Nov 7 2011,Elizabeth C. '13,International students @ MIT (+life updates),http://mitadmissions.org/blogs/entry/international-students-mit-life-updates,948,0,1,0,1
Nov 5 2011,ARTalk,Design in Boston,http://mitadmissions.org/blogs/entry/design-in-boston,950,3,2,1,6
Nov 5 2011,Chris Peterson,Aged And Confused,http://mitadmissions.org/blogs/entry/aged-and-confused,950,0,5,1,6
Nov 3 2011,MISTI Program,Need help choosing a MISTI program?,http://mitadmissions.org/blogs/entry/need-help-choosing-a-misti-program,952,0,2,0,2
Nov 2 2011,Chris Peterson,The Illusion Of Validity,http://mitadmissions.org/blogs/entry/the-illusion-of-validity,953,0,0,0,0
Nov 1 2011,Elizabeth C. '13,In Memoriam: Professor Silbey,http://mitadmissions.org/blogs/entry/in-memoriam-professor-silbey,954,2,5,0,7
Nov 1 2011,Matt McGann '00,November 1 Updates,http://mitadmissions.org/blogs/entry/early-action-updates,954,7,2,0,9
Oct 31 2011,Lydia K. '14,Pumpkin Drop,http://mitadmissions.org/blogs/entry/pumpkin-drop1,955,0,4,1,5
Oct 31 2011,Chris Peterson,Emergency Application Extension,http://mitadmissions.org/blogs/entry/important-emergency-application-extension,955,2,4,4,10
Oct 30 2011,Anna H. '14,This story has to do with professor accessibility.,http://mitadmissions.org/blogs/entry/something-awesome-came-in-the-mail,956,7,2,0,9
Oct 30 2011,Kirsten L. '15 ,Welcome to Maseeh!,http://mitadmissions.org/blogs/entry/welcome-to-maseeh,956,0,0,0,0
Oct 28 2011,ARTalk,Systems and Light,http://mitadmissions.org/blogs/entry/systems-and-light,958,0,0,0,0
Oct 27 2011,Chris M. '12,#Winning,http://mitadmissions.org/blogs/entry/winning,959,1,5,4,10
Oct 27 2011,MISTI Program,MIT EECS students travel the world,http://mitadmissions.org/blogs/entry/mit-eecs-students-travel-the-world,959,0,0,0,0
Oct 27 2011,Chris Peterson,The Difficulty With Data,http://mitadmissions.org/blogs/entry/the-difficulty-with-data,959,2,4,2,8
Oct 26 2011,Qiaochu Y. '12,Kids These Days Dont Know How Good Theyve Got It,http://mitadmissions.org/blogs/entry/kids-these-days-dont-know-how-good-theyve-got-it,960,0,3,4,7
Oct 25 2011,Matt McGann '00,Early Action Updates,http://mitadmissions.org/blogs/entry/ea-updates-2011,961,0,1,0,1
Oct 25 2011,Jenny X. '13,Our homework is to go camping,http://mitadmissions.org/blogs/entry/our-homework-is-to-go-camping,961,2,2,0,4
Oct 25 2011,David duKor-Jackson,Its not fair!,http://mitadmissions.org/blogs/entry/its-not-fair,961,0,2,0,2
Oct 24 2011,Lydia K. '14,Free Flu Shots,http://mitadmissions.org/blogs/entry/free-flu-shots,962,0,0,0,0
Oct 24 2011,Rachel F. '12,Doing What You Love,http://mitadmissions.org/blogs/entry/doing-what-you-love,962,0,1,0,1
Oct 24 2011,MISTI Program,Renewable Energy in Spain,http://mitadmissions.org/blogs/entry/renewable-energy-in-spain,962,1,2,0,3
Oct 24 2011,Gabe B. '13,Faith,http://mitadmissions.org/blogs/entry/faith,962,0,1,1,2
Oct 23 2011,Ana V. '15 ,Wake Up Calls,http://mitadmissions.org/blogs/entry/wake-up-calls,963,4,1,0,5
Oct 23 2011,Emad T. '14,Some Hosed Down Hodgepodge,http://mitadmissions.org/blogs/entry/some-hosed-down-hodgepodge,963,0,0,0,0
Oct 22 2011,Rachel F. '12,Still Alive!,http://mitadmissions.org/blogs/entry/still-alive,964,0,0,0,0
Oct 21 2011,Natnael G. '15,Measurements,http://mitadmissions.org/blogs/entry/measurements,965,6,1,0,7
Oct 21 2011,Mikey Yang '05,Our favoirte applicaiton spellnig errers,http://mitadmissions.org/blogs/entry/our-favoirte-applicaiton-spellnig-errers,965,1,6,6,13
Oct 20 2011,Chris Peterson,In Praise Of Holistic Admissions,http://mitadmissions.org/blogs/entry/in-praise-of-holistic-admissions,966,6,2,18,26
Oct 20 2011,Connie H. '15,How to MC Hammer,http://mitadmissions.org/blogs/entry/how-to-mc-hammer,966,0,1,0,1
Oct 19 2011,Kate R. '14,"Rainboots, Math, and M&Ms",http://mitadmissions.org/blogs/entry/rainboots-math-and-mms,967,0,0,0,0
Oct 19 2011,MISTI Program,Art & Science in Paris,http://mitadmissions.org/blogs/entry/art-science-paris,967,0,0,0,0
Oct 19 2011,MISTI Program,Jump into a new comfort zone!,http://mitadmissions.org/blogs/entry/germany-nina-sinatra,967,2,2,0,4
Oct 17 2011,ARTalk,Art is Everywhere!,http://mitadmissions.org/blogs/entry/art-is-everywhere,969,11,2,0,13
Oct 13 2011,David duKor-Jackson,In Search of Answers,http://mitadmissions.org/blogs/entry/in-search-of-answers,973,0,0,0,0
Oct 13 2011,Chris Peterson,Diversity or Merit?,http://mitadmissions.org/blogs/entry/diversity-or-merit,973,9,26,17,52
Oct 12 2011,Lydia K. '14,2 AM Destiny,http://mitadmissions.org/blogs/entry/2-am-destiny,974,0,0,0,0
Oct 12 2011,Kris Guay,Lobby 7,http://mitadmissions.org/blogs/entry/lobby-7,974,1,3,2,6
Oct 10 2011,Anna H. '14,Being qualified for MIT,http://mitadmissions.org/blogs/entry/being-qualified-for-mit,976,30,21,24,75
Oct 9 2011,Jenny X. '13,Are you a high school student?,http://mitadmissions.org/blogs/entry/are-you-a-high-school-student,977,0,0,0,0
Oct 9 2011,Chris M. '12,Angry Nerds,http://mitadmissions.org/blogs/entry/angry-nerds,977,2,6,1,9
Oct 8 2011,Kirsten L. '15 ,Small Victories,http://mitadmissions.org/blogs/entry/small-victories,978,0,1,0,1
Oct 8 2011,ARTalk,Untitled,http://mitadmissions.org/blogs/entry/untitled,978,0,0,0,0
Oct 8 2011,Matt McGann '00,Angry Birds Fly at MIT,http://mitadmissions.org/blogs/entry/angry-birds-fly-at-mit,978,130,105,53,288
Oct 6 2011,Chris Peterson,Steve and Me,http://mitadmissions.org/blogs/entry/steve-and-me,980,1,12,1,14
Oct 5 2011,Hamsika C. '13,Numbers,http://mitadmissions.org/blogs/entry/numbers,981,1,1,0,2
Oct 5 2011,Natnael G. '15,A Summer to Remember - Interphase,http://mitadmissions.org/blogs/entry/Interphase1,981,0,5,1,6
Oct 4 2011,Matt McGann '00,MIT Alum Adam Riess 92 Wins Nobel Prize,http://mitadmissions.org/blogs/entry/mit-alum-adam-riess-92-wins-nobel-prize,982,33,17,19,69
Oct 4 2011,Lydia K. '14,Planned Procrastination,http://mitadmissions.org/blogs/entry/planned-procrastination,982,0,1,7,8
Oct 1 2011,Chris Peterson,Theres something happening here,http://mitadmissions.org/blogs/entry/theres-something-happening-here,985,0,0,0,0
Sep 29 2011,Chris Peterson,Guest Blog: A Guide for the Hopeless and Drenched,http://mitadmissions.org/blogs/entry/guest-blog-a-guide-for-the-hopeless-and-drenched,987,7,8,5,20
Sep 28 2011,Lydia K. '14,End-of-Summer Camping,http://mitadmissions.org/blogs/entry/end-of-summer-camping1,988,0,0,0,0
Sep 27 2011,Mikey Yang '05,There Goes My Baby,http://mitadmissions.org/blogs/entry/there-goes-my-baby,989,1,6,2,9
Sep 27 2011,Piper '13,Like a G6,http://mitadmissions.org/blogs/entry/like-a-g6,989,0,3,1,4
Sep 25 2011,Jenny X. '13,Lets see those cell phones up in the air,http://mitadmissions.org/blogs/entry/lets-see-those-cell-phones-up-in-the-air,991,0,1,0,1
Sep 25 2011,Ana V. '15 ,May we offer you a drink of water?,http://mitadmissions.org/blogs/entry/may-we-offer-you-a-drink-of-water,991,4,5,6,15
Sep 25 2011,Chris Peterson,Ask Me Anything,http://mitadmissions.org/blogs/entry/ask-me-anything,991,0,0,0,0
Sep 24 2011,Emad T. '14,My Freshman Backpack,http://mitadmissions.org/blogs/entry/my-freshman-backpack,992,0,2,0,2
Sep 23 2011,Chris Peterson,Facebook & Google Plus,http://mitadmissions.org/blogs/entry/facebook-google-plus,993,1,3,0,4
Sep 22 2011,Elizabeth C. '13,Freebieasy,http://mitadmissions.org/blogs/entry/freebieasy,994,0,1,0,1
Sep 22 2011,Qiaochu Y. '12,The Good Stuff,http://mitadmissions.org/blogs/entry/the-good-stuff,994,5,2,0,7
Sep 22 2011,Piper '13,A Day in the Life,http://mitadmissions.org/blogs/entry/a-day-in-the-life,994,0,1,0,1
Sep 21 2011,Anna H. '14,Pay it forward,http://mitadmissions.org/blogs/entry/pay-it-forward,995,10,6,1,17
Sep 20 2011,Rachel F. '12,Im so ill.,http://mitadmissions.org/blogs/entry/im-so-ill,996,0,1,0,1
Sep 20 2011,Matt McGann '00,MIT DDR Tetris on 6-foot LED Matrix,http://mitadmissions.org/blogs/entry/mit-ddr-tetris-on-6-foot-led-matrix,996,4,8,5,17
Sep 20 2011,Kate R. '14,Why was I up so early this weekend?,http://mitadmissions.org/blogs/entry/why-was-i-up-so-early-this-weekend,996,0,0,0,0
Sep 19 2011,Kirsten L. '15 ,Meant to Be,http://mitadmissions.org/blogs/entry/meant-to-be,997,7,3,0,10
Sep 18 2011,Gabe B. '13,Derailment,http://mitadmissions.org/blogs/entry/derailment,998,0,4,0,4
Sep 15 2011,Rachel F. '12,"MIT, Part VII",http://mitadmissions.org/blogs/entry/mit-part-vii,1001,0,0,0,0
Sep 15 2011,Connie H. '15,Fit,http://mitadmissions.org/blogs/entry/fit,1001,12,4,2,18
Sep 15 2011,Chris Peterson,Food Fights,http://mitadmissions.org/blogs/entry/food-fights,1001,1,1,1,3
Sep 12 2011,Chris M. '12,Tweaching and Stitches,http://mitadmissions.org/blogs/entry/tweaching-and-stitches,1004,0,0,0,0
Sep 11 2011,Qiaochu Y. '12,The Availability Heuristic,http://mitadmissions.org/blogs/entry/the-availability-heuristic,1005,10,6,2,18
Sep 11 2011,David duKor-Jackson,Parental Advice,http://mitadmissions.org/blogs/entry/parental-advice,1005,2,6,3,11
Sep 9 2011,Anna H. '14,"Beauty, xkcd, and my classes",http://mitadmissions.org/blogs/entry/beauty-xkcd-and-my-classes,1007,0,2,0,2
Sep 9 2011,Elizabeth C. '13,ThisIsBLODGEBALL!,http://mitadmissions.org/blogs/entry/thisisblodgeball,1007,2,2,2,6
Sep 9 2011,Natnael G. '15,Not in Kansas anymore,http://mitadmissions.org/blogs/entry/not-in-kansas-anymore,1007,0,2,6,8
Sep 8 2011,Mikey Yang '05,Questbridge College Admissions Conference,http://mitadmissions.org/blogs/entry/questbridge-college-admissions-conference,1008,16,8,1,25
Sep 8 2011,Lydia K. '14,"print Hello, World!\n;",http://mitadmissions.org/blogs/entry/print-hello-worldn1,1008,1,1,0,2
Sep 8 2011,Kris Guay,Forget your plan for a minute,http://mitadmissions.org/blogs/entry/forget-your-plan-for-a-minute,1008,4,2,10,16
Sep 8 2011,Jenny X. '13,That fear of falling behind,http://mitadmissions.org/blogs/entry/that-fear-of-falling-behind,1008,0,1,0,1
Sep 6 2011,Tom R. '14,Its FPOPpin,http://mitadmissions.org/blogs/entry/its-fpoppin,1010,0,0,0,0
Sep 5 2011,Anna H. '14,"Q&A: Food on campus, UROPs, decisions",http://mitadmissions.org/blogs/entry/qa-food-on-campus-urops-decisions,1011,0,0,0,0
Sep 5 2011,Kirsten L. '15 ,A Maple Peach in Cambridge,http://mitadmissions.org/blogs/entry/talking-about-myself-is-weird,1011,4,2,0,6
Sep 3 2011,Chris M. '12,Learning more than just math,http://mitadmissions.org/blogs/entry/learning-more-than-just-math,1013,1,2,0,3
Sep 3 2011,Ana V. '15 ,Not About the Name,http://mitadmissions.org/blogs/entry/not-about-the-name,1013,18,5,4,27
Sep 2 2011,Beatriz Valdez,Ethnicity Information (Optional),http://mitadmissions.org/blogs/entry/ethnicity-information-optional1,1014,22,4,5,31
Sep 2 2011,Anna H. '14,I can tell that we are gonna be friends (part 1),http://mitadmissions.org/blogs/entry/i-can-tell-that-we-are-gonna-be-friends,1014,0,0,0,0
Sep 1 2011,Qiaochu Y. '12,Bloggerduction,http://mitadmissions.org/blogs/entry/bloggerduction,1015,15,1,4,20
Sep 1 2011,Chris Peterson,What Are We Waiting For,http://mitadmissions.org/blogs/entry/what-are-we-waiting-for,1015,20,10,3,33
Sep 1 2011,Matt McGann '00,MIT Application now available,http://mitadmissions.org/blogs/entry/mit-application-now-available,1015,14,7,31,52
Aug 30 2011,Chris S. '11,Life After MIT,http://mitadmissions.org/blogs/entry/life-after-mit,1017,0,1,3,4
Aug 30 2011,Kate R. '14,Building a Ballpit,http://mitadmissions.org/blogs/entry/building-a-ballpit,1017,0,0,0,0
Aug 29 2011,Kris Guay,You Are Welcome Here,http://mitadmissions.org/blogs/entry/you-are-welcome-here,1018,4,1,2,7
Aug 29 2011,Gabe B. '13,So you want to be a student-athlete?,http://mitadmissions.org/blogs/entry/so-you-want-to-be-a-student-athlete,1018,0,0,0,0
Aug 28 2011,Chris Peterson,MIT IreneCam,http://mitadmissions.org/blogs/entry/mit-irenecam,1019,7,2,0,9
Aug 27 2011,Rachel F. '12,Y U NO HAVE ROLLERCOASTER,http://mitadmissions.org/blogs/entry/y-u-no-have-rollercoaster,1020,1,2,0,3
Aug 26 2011,Anna H. '14,Trumpeting for Assassins,http://mitadmissions.org/blogs/entry/trumpeting-for-assassins1,1021,0,0,0,0
Aug 26 2011,Piper '13,Whats on your mind?,http://mitadmissions.org/blogs/entry/whats-on-your-mind,1021,0,0,0,0
Aug 26 2011,Chris Peterson,"My Life, As Physics Problem",http://mitadmissions.org/blogs/entry/my-life-as-physics-problem,1021,1,1,0,2
Aug 25 2011,Chris S. '11,So You Wanna Be a Doctor?,http://mitadmissions.org/blogs/entry/premed,1022,0,6,16,22
Aug 24 2011,Piper '13,Help@MIT,http://mitadmissions.org/blogs/entry/help-at-mit,1023,0,0,0,0
Aug 24 2011,Chris Peterson,Learning To Learn At MIT,http://mitadmissions.org/blogs/entry/learning-to-learn-at-mit,1023,19,7,1,27
Aug 22 2011,Jenny X. '13,NIGHTMARISH THOUGHTS,http://mitadmissions.org/blogs/entry/nightmarish-thoughts,1025,0,0,0,0
Aug 22 2011,Matt McGann '00,Welcome MIT Class of 2015,http://mitadmissions.org/blogs/entry/welcome-mit-class-of-2015,1025,8,3,2,13
Aug 22 2011,Rachel F. '12,My Stomach Overrides All Priorities,http://mitadmissions.org/blogs/entry/my-stomach-overrides-all-priorities,1025,0,0,0,0
Aug 19 2011,Chris M. '12,Some Good Advice,http://mitadmissions.org/blogs/entry/some-good-advice,1028,0,0,0,0
Aug 19 2011,Chris Peterson,Angular Velocity Saved My Life,http://mitadmissions.org/blogs/entry/angular-velocity-saved-my-life,1028,7,7,12,26
Aug 19 2011,Piper '13,Space Robots,http://mitadmissions.org/blogs/entry/space-robots,1028,0,0,0,0
Aug 19 2011,Anna H. '14,19 Summers,http://mitadmissions.org/blogs/entry/19-summers1,1028,0,0,0,0
Aug 18 2011,Public Service Center,Reflections on a summer spent designing wheelchairs in Guatemala,http://mitadmissions.org/blogs/entry/reflections-on-a-summer-spent-designing-wheelchairs-in-guatemala,1029,0,0,0,0
Aug 18 2011,Kris Guay,Cancer on my mind,http://mitadmissions.org/blogs/entry/cancer-on-my-mind,1029,2,1,0,3
Aug 17 2011,Rachel F. '12,Blogging Is The Salt Shaker Of My Life,http://mitadmissions.org/blogs/entry/blogging-is-the-salt-shaker-of-my-life,1030,0,0,0,0
Aug 17 2011,Chris Peterson,Meet The (New) Bloggers!,http://mitadmissions.org/blogs/entry/meet-the-new-bloggers,1030,24,5,19,48
Aug 17 2011,Emad T. '14,Never Mind The Score,http://mitadmissions.org/blogs/entry/never-mind-the-score,1030,0,2,0,2
Aug 16 2011,Chancellor Eric Grimson,Chancellor? Whats a Chancellor?,http://mitadmissions.org/blogs/entry/chancellor-whats-a-chancellor,1031,10,6,8,24
Aug 16 2011,Gabe B. '13,The Answer is Yes,http://mitadmissions.org/blogs/entry/the-answer-is-yes,1031,0,1,0,1
Aug 15 2011,Chris Peterson,I would like to find an astronomer to talk to,http://mitadmissions.org/blogs/entry/i-would-like-to-find-an-astronomer-to-talk-to,1032,0,0,0,0
Aug 15 2011,Hamsika C. '13,MCAT Advice,http://mitadmissions.org/blogs/entry/mcat-advice,1032,2,4,0,6
Aug 12 2011,Elizabeth C. '13,Summer Listening,http://mitadmissions.org/blogs/entry/summer-listening,1035,0,0,0,0
Aug 10 2011,David duKor-Jackson,Esse quam videri,http://mitadmissions.org/blogs/entry/esse-quam-videri,1037,52,36,43,131
Aug 7 2011,Emad T. '14,Massachusetts: The Geek State,http://mitadmissions.org/blogs/entry/massachusetts-the-geek-state,1040,0,0,0,0
Aug 5 2011,Gabe B. '13,"Reading, Thinking and Igniting Innovation",http://mitadmissions.org/blogs/entry/reading-thinking-igniting,1042,0,0,0,0
Aug 4 2011,Kris Guay,Summer Reading,http://mitadmissions.org/blogs/entry/summer-reading,1043,0,1,6,7
Aug 4 2011,Chris S. '11,Ratification: The Story of the US Constitution,http://mitadmissions.org/blogs/entry/ratification1,1043,3,3,0,6
Aug 3 2011,Elizabeth C. '13,"Oh cruel, cursed fate!",http://mitadmissions.org/blogs/entry/oh-cruel-cursed-fate,1044,0,0,0,0
Aug 2 2011,Anna H. '14,Making friends at college,http://mitadmissions.org/blogs/entry/making-friends-at-college,1045,7,6,12,25
Aug 2 2011,Rachel F. '12,Call For A Good Time,http://mitadmissions.org/blogs/entry/call-for-a-good-time,1045,1,1,0,2
Aug 1 2011,Matt McGann '00,MIT Application: August 19,http://mitadmissions.org/blogs/entry/mit-application-august-19,1046,27,16,17,60
Jul 31 2011,Emad T. '14,A Brief Retreat,http://mitadmissions.org/blogs/entry/a-brief-retreat,1047,0,0,0,0
Jul 29 2011,Chris M. '12,A Sorting Hat of Sorts,http://mitadmissions.org/blogs/entry/a-sorting-hat-of-sorts,1049,2,4,18,24
Jul 29 2011,Chris Peterson,MIT Movies Emeritus,http://mitadmissions.org/blogs/entry/mit-movies-emeritus,1049,0,3,0,3
Jul 28 2011,Matt McGann '00,Prof. Missy Cummings on The Colbert Report,http://mitadmissions.org/blogs/entry/prof.-missy-cummings-on-the-colbert-report,1050,0,2,0,2
Jul 26 2011,Gabe B. '13,3 Lessons Learned While Hiking,http://mitadmissions.org/blogs/entry/3-lessons-learned-while-hiking1,1052,0,1,1,2
Jul 26 2011,Chris Peterson,"Go West, Young Man",http://mitadmissions.org/blogs/entry/go-west-young-man,1052,10,7,7,24
Jul 26 2011,Maggie L. '12,As I Was Saying,http://mitadmissions.org/blogs/entry/as-i-was-saying,1052,0,0,0,0
Jul 25 2011,Cydnie T. '12,The 12 Step Plan,http://mitadmissions.org/blogs/entry/the-12-step-plan,1053,0,0,0,0
Jul 22 2011,Chris Peterson,Blogger Application 2011!,http://mitadmissions.org/blogs/entry/blogger-application-2011,1056,3,5,2,10
Jul 22 2011,Hamsika C. '13,The Truth About Science,http://mitadmissions.org/blogs/entry/the-truth-about-science,1056,0,0,0,0
Jul 20 2011,Chris Peterson,L@@K at the Class of 2015,http://mitadmissions.org/blogs/entry/lk-at-the-class-of-2015,1058,62,43,94,199
Jul 20 2011,Jenny X. '13,Choose Your Own Adventure,http://mitadmissions.org/blogs/entry/choose-your-own-adventure,1058,0,0,0,0
Jul 19 2011,Emad T. '14,Tangential Learning,http://mitadmissions.org/blogs/entry/tangential-learning,1059,0,1,0,1
Jul 17 2011,Maggie L. '12,How the Career Fair saved my summer,http://mitadmissions.org/blogs/entry/how-the-career-fair-saved-my-summer,1061,0,0,0,0
Jul 17 2011,Cam T. '13,(Still) Celebrating the 150th!,http://mitadmissions.org/blogs/entry/still-celebrating-the-150th,1061,1,0,0,1
Jul 16 2011,Rachel F. '12,Navigating The TunnelsOf Freshman Academics,http://mitadmissions.org/blogs/entry/navigating-the-tunnels...of-freshman-academics,1062,0,0,0,0
Jul 14 2011,David duKor-Jackson,Putting Diversity into Context,http://mitadmissions.org/blogs/entry/which-box-should-i-check,1064,0,8,0,8
Jul 14 2011,Kate R. '14,Guest Lectures,http://mitadmissions.org/blogs/entry/guest-lectures,1064,0,0,0,0
Jul 13 2011,Matt McGann '00,MIT salutes Harry Potter,http://mitadmissions.org/blogs/entry/mit-salutes-harry-potter,1065,116,60,48,224
Jul 12 2011,Hamsika C. '13,Ups and Downs,http://mitadmissions.org/blogs/entry/ups-and-downs,1066,2,2,3,7
Jul 11 2011,Chris Peterson,Welcome Home,http://mitadmissions.org/blogs/entry/welcome-home,1067,26,3,13,42
Jul 11 2011,David duKor-Jackson,Just getting started,http://mitadmissions.org/blogs/entry/just-getting-started,1067,0,0,0,0
Jul 8 2011,Cydnie T. '12,Thing-A-Mah-Bobs,http://mitadmissions.org/blogs/entry/thingamahbobs,1070,0,0,0,0
Jul 7 2011,Chris S. '11,MIT Academics,http://mitadmissions.org/blogs/entry/mit_academics,1071,18,32,19,69
Jul 7 2011,Anna H. '14,How to get a UROP,http://mitadmissions.org/blogs/entry/how_to_get_a_urop,1071,4,3,0,7
Jul 6 2011,Kate R. '14,Awesome Diva adventures,http://mitadmissions.org/blogs/entry/awesome_diva_adventures,1072,4,1,0,5
Jul 4 2011,Kris Guay,Whats in a name?,http://mitadmissions.org/blogs/entry/whats_in_a_name_1,1074,0,0,0,0
Jul 2 2011,Elizabeth C. '13,Q&A Vol. III,http://mitadmissions.org/blogs/entry/qa_vol_iv,1076,0,0,0,0
Jul 1 2011,Rachel F. '12,Rachel was at SF Pride,http://mitadmissions.org/blogs/entry/rachel_was_at_sf_pride,1077,0,0,0,0
Jun 29 2011,Matt McGann '00,Biology-inspired design from MIT alums,http://mitadmissions.org/blogs/entry/biologyinspired_design_from_mi,1079,0,0,0,0
Jun 29 2011,Anna H. '14,Hospital Trips and Dance Parties,http://mitadmissions.org/blogs/entry/hospital_trips_and_dance_parties,1079,0,0,0,0
Jun 28 2011,Jenny X. '13,Things got poopy in Beijing,http://mitadmissions.org/blogs/entry/things_got_poopy_in_beijing_1,1080,2,4,16,22
Jun 27 2011,Chris Peterson,Nerd Camp,http://mitadmissions.org/blogs/entry/nerd_camp,1081,0,1,0,1
Jun 25 2011,Rachel F. '12,Move Fast And Break Things,http://mitadmissions.org/blogs/entry/move_fast_and_break_things,1083,12,4,9,25
Jun 23 2011,Maggie L. '12,A fortnight of Boston summer,http://mitadmissions.org/blogs/entry/a_fortnight_of_boston,1085,0,0,0,0
Jun 22 2011,Chris M. '12,A Brief History of Hacks,http://mitadmissions.org/blogs/entry/a_brief_history_of_hacks,1086,0,0,0,0
Jun 19 2011,Hamsika C. '13,Lessons Learned in Lab,http://mitadmissions.org/blogs/entry/lessons_learned_in_lab,1089,0,0,0,0
Jun 19 2011,Snively '11,This is the end,http://mitadmissions.org/blogs/entry/this_is_the_end,1089,3,2,2,7
Jun 18 2011,Cydnie T. '12,Let the good times roll,http://mitadmissions.org/blogs/entry/let_the_good_times_roll,1090,0,0,0,0
Jun 17 2011,Jenny X. '13,They say you learn more by living abroad,http://mitadmissions.org/blogs/entry/they_say_you_learn_more_by_liv,1091,0,0,0,0
Jun 15 2011,Chris S. '11,101 Things To Do Before You Graduate!,http://mitadmissions.org/blogs/entry/101_things_to_do_before_you_gr,1093,10,7,4,21
Jun 15 2011,Chris Peterson,BRUINS!!!,http://mitadmissions.org/blogs/entry/bruins,1093,0,0,0,0
Jun 14 2011,Hamsika C. '13,Starbucks.,http://mitadmissions.org/blogs/entry/starbucks,1094,0,0,0,0
Jun 13 2011,Kris Guay,Writing is Magic,http://mitadmissions.org/blogs/entry/writing_is_magic,1095,0,1,0,1
Jun 13 2011,Chris Peterson,Trip Report: IvyPlus,http://mitadmissions.org/blogs/entry/trip_report_ivyplus,1095,0,1,0,1
Jun 13 2011,Alina G. '11,"Seatbelts, Everyone!",http://mitadmissions.org/blogs/entry/seatbelts_everyone_1,1095,0,0,0,0
Jun 12 2011,Anna H. '14,I know youre bad at something,http://mitadmissions.org/blogs/entry/i_know_youre_bad_at_something,1096,1,0,0,1
Jun 12 2011,Emad T. '14,Lazy Day,http://mitadmissions.org/blogs/entry/lazy_day_1,1096,0,0,0,0
Jun 11 2011,Chris M. '12,On Greatness,http://mitadmissions.org/blogs/entry/on_greatness,1097,0,0,0,0
Jun 10 2011,Cam T. '13,"Recycle, Reuse, (Map) Reduce?",http://mitadmissions.org/blogs/entry/recycle_reuse_map_reduce,1098,0,0,0,0
Jun 9 2011,Elijah T. '11 ,Full Steam Ahead,http://mitadmissions.org/blogs/entry/full_steam_ahead,1099,0,0,0,0
Jun 6 2011,Kris Guay,Celebrate the Good Times,http://mitadmissions.org/blogs/entry/celebrate_the_good_times,1102,0,0,0,0
Jun 3 2011,Chris Peterson,Life is Improv,http://mitadmissions.org/blogs/entry/life_is_improv,1105,10,8,8,26
Jun 3 2011,Emad T. '14,Guest Post: Think Pink 2011,http://mitadmissions.org/blogs/entry/guest_post_think_pink_2011,1105,0,0,0,0
Jun 2 2011,Chris Peterson,Things Charles Has Made,http://mitadmissions.org/blogs/entry/things_charles_has_made,1106,0,1,0,1
Jun 1 2011,Elizabeth C. '13,I get by with a lot of help from my friends,http://mitadmissions.org/blogs/entry/i_get_by_with_a_lot_of_help_fr,1107,0,0,0,0
May 31 2011,Jenny X. '13,Summer at last,http://mitadmissions.org/blogs/entry/summer_at_last,1108,0,0,0,0
May 31 2011,Anna H. '14,Note To Self,http://mitadmissions.org/blogs/entry/note_to_self,1108,3,2,0,5
May 31 2011,Chris M. '12,Summer Season,http://mitadmissions.org/blogs/entry/summer_season,1108,0,0,0,0
May 30 2011,Jess K. '10,"Appreciating America in Tokyo (or Things I Never Finished, Part Two)",http://mitadmissions.org/blogs/entry/appreciating_america_in_tokyo,1109,0,0,0,0
May 30 2011,Rachel F. '12,Face Book And Study,http://mitadmissions.org/blogs/entry/face_book_and_study,1109,1,0,0,1
May 29 2011,Hamsika C. '13,Back to Boston,http://mitadmissions.org/blogs/entry/back_to_boston_1,1110,0,0,0,0
May 29 2011,Piper '13,Above MIT,http://mitadmissions.org/blogs/entry/above_mit,1110,0,0,0,0
May 27 2011,Kris Guay,Metabo lite s,http://mitadmissions.org/blogs/entry/metabolite_s,1112,0,0,0,0
May 27 2011,Chris Peterson,50 Things (That MIT Made),http://mitadmissions.org/blogs/entry/50_things_that_mit_made,1112,28,30,11,69
May 26 2011,Matt McGann '00,Incentive to Drop Out,http://mitadmissions.org/blogs/entry/incentive_to_drop_out,1113,1,0,0,1
May 25 2011,Emad T. '14,"The Bloggers Cut, Year One",http://mitadmissions.org/blogs/entry/the_bloggers_cut_year_one,1114,0,0,0,0
May 23 2011,Chris Peterson,Maker Faire 2011,http://mitadmissions.org/blogs/entry/maker_faire_2011,1116,1,0,0,1
May 22 2011,ARTalk,"Music Groups at MIT, Pt. 3",http://mitadmissions.org/blogs/entry/music_groups_at_mit_pt_iii,1117,0,0,0,0
May 21 2011,Maggie L. '12,Totally awesome,http://mitadmissions.org/blogs/entry/so_much_awesome,1118,0,0,0,0
May 20 2011,Hamsika C. '13,150.,http://mitadmissions.org/blogs/entry/150_1,1119,0,0,0,0
May 19 2011,Emad T. '14,(Paint)Ballin,http://mitadmissions.org/blogs/entry/paintballin,1120,0,0,0,0
May 10 2011,Jenny X. '13,LIGHTS.,http://mitadmissions.org/blogs/entry/lights,1129,0,0,0,0
May 10 2011,Mikey Yang '05,Waitlist Decisions 2011,http://mitadmissions.org/blogs/entry/waitlist_decisions_2011_1,1129,0,0,0,0
May 10 2011,Chris Peterson,"Linkdump: Smart Leaves, Burritos, and Shaq",http://mitadmissions.org/blogs/entry/linkdump_leaves_burritos_and_s,1129,0,0,0,0
May 9 2011,Anna H. '14,Theres More to Life Than Tooling,http://mitadmissions.org/blogs/entry/theres_more_to_life_than_tooling,1130,0,0,0,0
May 8 2011,Elizabeth C. '13,"Hello, strangers.",http://mitadmissions.org/blogs/entry/hello_strangers,1131,0,0,0,0
May 7 2011,Cam T. '13,How many engineers does it take to change a light bulb?,http://mitadmissions.org/blogs/entry/how_many_engineers_does_it_tak,1132,0,0,0,0
May 7 2011,Emad T. '14,Stepping Up,http://mitadmissions.org/blogs/entry/stepping_up_1,1132,0,0,0,0
May 6 2011,ARTalk,"Music Groups at MIT, Pt.2",http://mitadmissions.org/blogs/entry/music_groups_at_mit_pt2,1133,0,0,0,0
May 6 2011,Maggie L. '12,Engineering leadership: the one-hour edition,http://mitadmissions.org/blogs/entry/engineering_leadership_the_one_1,1133,0,0,0,0
May 4 2011,Chris Peterson,[Infinite] Quarter Mile,http://mitadmissions.org/blogs/entry/infinite_quarter_mile,1135,0,0,0,0
May 3 2011,ARTalk,"LIVE-BROADCAST: With the Void, Full of Powers",http://mitadmissions.org/blogs/entry/with_the_void_full_of_powers,1136,0,0,0,0
May 3 2011,Chris M. '12,"Harbinger of Doom, Despair, and Knowledge: PSETS",http://mitadmissions.org/blogs/entry/harbinger_of_doom_despair_and,1136,3,6,12,21
May 3 2011,ARTalk,"Music Groups at MIT, Pt. 1",http://mitadmissions.org/blogs/entry/music_groups_at_mit_pt_1,1136,0,0,0,0
May 1 2011,Rachel F. '12,Guest Entry: A Yankee in Cambridge,http://mitadmissions.org/blogs/entry/guest_entry_a_yankee_in_cambri,1138,0,0,0,0
Apr 30 2011,Chris S. '11,"Dang Right, Were Cooler Than You",http://mitadmissions.org/blogs/entry/dang_right_were_cooler_than_yo,1139,0,0,0,0
Apr 28 2011,ARTalk,Unlike any other.,http://mitadmissions.org/blogs/entry/unlike_any_other,1141,0,0,0,0
Apr 28 2011,Emad T. '14,Coming Soon!,http://mitadmissions.org/blogs/entry/coming_soon_1,1141,0,0,0,0
Apr 28 2011,Matt McGann '00,Updates from Admissions,http://mitadmissions.org/blogs/entry/updates_from_admissions,1141,0,0,0,0
Apr 27 2011,Chris Peterson,Worlds Best Rib Recipe,http://mitadmissions.org/blogs/entry/worlds_best_rib_recipe,1142,0,0,0,0
Apr 27 2011,Maggie L. '12,MIT Open House,http://mitadmissions.org/blogs/entry/mit_open_house,1142,2,0,0,2
Apr 26 2011,Kris Guay,Public Art,http://mitadmissions.org/blogs/entry/public_art,1143,0,0,0,0
Apr 26 2011,Hamsika C. '13,Cool People. And Lunch!,http://mitadmissions.org/blogs/entry/cool_people_and_lunch,1143,0,0,0,0
Apr 24 2011,Rachel F. '12,This is what happens when we dont do work,http://mitadmissions.org/blogs/entry/this_is_what_happens_when_we_d_1,1145,0,0,0,0
Apr 23 2011,Chris S. '11,I Really Just Cannot Write Anymore of My Thesis,http://mitadmissions.org/blogs/entry/i_really_just_cannot_write_any,1146,2,4,0,6
Apr 22 2011,Anna H. '14,A *Major* Dilemma,http://mitadmissions.org/blogs/entry/a_major_dilemma,1147,3,1,0,4
Apr 22 2011,ARTalk,A Weekend in New York,http://mitadmissions.org/blogs/entry/a_weekend_in_new_york,1147,0,0,0,0
Apr 22 2011,Hamsika C. '13,Happiness,http://mitadmissions.org/blogs/entry/happiness,1147,0,0,0,0
Apr 21 2011,Chris Peterson,Finding Your Match,http://mitadmissions.org/blogs/entry/finding_your_match,1148,0,0,0,0
Apr 19 2011,Elijah T. '11 ,Marathon Monday,http://mitadmissions.org/blogs/entry/marathon_monday,1150,0,0,0,0
Apr 18 2011,Elizabeth C. '13,"Q&A, Vol. II",http://mitadmissions.org/blogs/entry/qa_vol_ii,1151,1,0,0,1
Apr 16 2011,Jenny X. '13,Cute! an MIT mood meter -,http://mitadmissions.org/blogs/entry/cute,1153,0,1,0,1
Apr 14 2011,Rachel F. '12,Guest Entry: Engineers Without Borders,http://mitadmissions.org/blogs/entry/guest_post_engineers_without_b,1155,0,0,0,0
Apr 12 2011,Chris Peterson,Inventional YoYo,http://mitadmissions.org/blogs/entry/inventional_yoyo,1157,0,0,0,0
Apr 11 2011,Kris Guay,Sacred Space,http://mitadmissions.org/blogs/entry/sacred_space,1158,0,0,0,0
Apr 11 2011,Matt McGann '00,On taking a Gap Year,http://mitadmissions.org/blogs/entry/on_taking_a_gap_year_2,1158,1,2,0,3
Apr 7 2011,Hamsika C. '13,Presenting MITs Newest Truman Scholar!,http://mitadmissions.org/blogs/entry/presenting_mits_newest_truman_1,1162,0,0,0,0
Apr 7 2011,Kate R. '14,A CPW Challenge,http://mitadmissions.org/blogs/entry/a_cpw_challenge,1162,0,0,0,0
Apr 6 2011,Chris M. '12,Get excited for CPW!,http://mitadmissions.org/blogs/entry/get_excited_for_cpw,1163,0,0,0,0
Apr 6 2011,Elizabeth C. '13,Coming up with entry titles is harder than it seems,http://mitadmissions.org/blogs/entry/coming_up_with_entry_titles_is,1163,0,0,0,0
Apr 6 2011,Mikey Yang '05,CPW 2011 Closing Remarks and Variety Show,http://mitadmissions.org/blogs/entry/cpw_2011_closing_remarks_and_v,1163,0,0,0,0
Apr 5 2011,Hamsika C. '13,Giving Back (Guest Entry),http://mitadmissions.org/blogs/entry/giving_back,1164,0,0,0,0
Apr 4 2011,Cam T. '13,More than 9000 reasons,http://mitadmissions.org/blogs/entry/more_than_9000_reasons,1165,0,0,0,0
Apr 4 2011,Snively '11,how ARe you today?,http://mitadmissions.org/blogs/entry/how_are_you_today,1165,0,0,0,0
Apr 3 2011,Rachel F. '12,Sneak Preview (to next) Weekend,http://mitadmissions.org/blogs/entry/sneak_preview_to_next_weekend,1166,0,0,0,0
Apr 2 2011,Hamsika C. '13,Cultured,http://mitadmissions.org/blogs/entry/cultured_1,1167,0,0,0,0
Apr 2 2011,Cydnie T. '12,Week(end) [Read: New York] Adventures Parts 2-4,http://mitadmissions.org/blogs/entry/weekend_read_new_york_adventur,1167,0,0,0,0
Apr 1 2011,Kim Hunter '86,CPW is for Parents tooreally!!,http://mitadmissions.org/blogs/entry/cpw_is_for_parents_tooreally,1168,0,0,0,0
Apr 1 2011,Elijah T. '11 ,A Night at the Office,http://mitadmissions.org/blogs/entry/a_night_at_the_office,1168,0,0,0,0
Mar 31 2011,Hamsika C. '13,"Looking Back, Looking Forward",http://mitadmissions.org/blogs/entry/looking_back_looking_forward,1169,0,0,0,0
Mar 30 2011,Kris Guay,"Concourse, of course",http://mitadmissions.org/blogs/entry/concourse_of_course,1170,0,0,0,0
Mar 29 2011,Anna H. '14,Introducing: La Maison Franaise (French House),http://mitadmissions.org/blogs/entry/introducing_la_maison_francais,1171,0,0,0,0
Mar 28 2011,Chris Peterson,AgeLab,http://mitadmissions.org/blogs/entry/agelab,1172,0,0,0,0
Mar 27 2011,ARTalk,Love Affair: 11.027 & New Orleans,http://mitadmissions.org/blogs/entry/love_affair_11027_new_orleans,1173,0,0,0,0
Mar 27 2011,Alina G. '11,Looking Backwards,http://mitadmissions.org/blogs/entry/looking_backwards_1,1173,0,0,0,0
Mar 26 2011,Matt McGann '00,The MIT Spring Concert,http://mitadmissions.org/blogs/entry/the_mit_spring_concert_1,1174,14,7,14,35
Mar 25 2011,Chris Peterson,"Its Friday, Friday",http://mitadmissions.org/blogs/entry/its_friday_friday,1175,0,0,0,0
Mar 23 2011,Chris Peterson,MIT (Maker) Women Rock,http://mitadmissions.org/blogs/entry/mit_maker_women_rock,1177,3,2,1,6
Mar 22 2011,Kris Guay,Under the Dome,http://mitadmissions.org/blogs/entry/under_the_dome,1178,0,0,0,0
Mar 22 2011,Jenny X. '13,Accountability,http://mitadmissions.org/blogs/entry/accountability,1178,0,0,0,0
Mar 19 2011,Emad T. '14,Reference Frames,http://mitadmissions.org/blogs/entry/reference_frames,1181,0,0,0,0
Mar 18 2011,Rachel F. '12,The Best (Work-Related) All-Nighter Ever,http://mitadmissions.org/blogs/entry/the_best_workrelated_allnighte,1182,0,1,0,1
Mar 17 2011,Kate R. '14,In Defense of Peer Pressure,http://mitadmissions.org/blogs/entry/in_defense_of_peer_pressure,1183,0,0,0,0
Mar 17 2011,Cydnie T. '12,Guest Blog: Math. by Joy 13,http://mitadmissions.org/blogs/entry/guest_blog_math_by_joy_13,1183,1,0,0,1
Mar 17 2011,ARTalk,DEATH AND THE POWERS: The Robots Opera,http://mitadmissions.org/blogs/entry/death_and_the_powers_the_robot,1183,0,0,0,0
Mar 17 2011,Kim Hunter '86,Newly Admitted Student Events,http://mitadmissions.org/blogs/entry/newly_admitted_student_events,1183,0,0,0,0
Mar 16 2011,Mikey Yang '05,Bleary-eyed,http://mitadmissions.org/blogs/entry/blearyeyed,1184,32,15,15,62
Mar 15 2011,Matt McGann '00,News for Admitted Students,http://mitadmissions.org/blogs/entry/news_for_admitted_students,1185,0,1,0,1
Mar 15 2011,Matt McGann '00,Waitlist Q&A,http://mitadmissions.org/blogs/entry/waitlist_qa,1185,1,0,0,1
Mar 14 2011,Decisions,MIT Admissions Decisions Now Available Online,http://mitadmissions.org/blogs/entry/mit_admissions_decisions_now_a,1186,0,0,0,0
Mar 14 2011,Decisions,Open Thread for Admitted Students,http://mitadmissions.org/blogs/entry/open_thread_for_admitted_stude,1186,0,0,0,0
Mar 14 2011,Decisions,Open Thread for Waitlisted Students,http://mitadmissions.org/blogs/entry/open_thread_for_waitlisted_stu,1186,0,0,0,0
Mar 14 2011,Decisions,Open Thread For Those Not Admitted,http://mitadmissions.org/blogs/entry/open_thread_for_those_not_admi,1186,2,1,3,6
Mar 13 2011,Cydnie T. '12,Sabrosura!,http://mitadmissions.org/blogs/entry/sabrosura,1187,0,0,0,0
Mar 13 2011,ARTalk,Metropolis and the Alloy Orchestra,http://mitadmissions.org/blogs/entry/metropolis_and_the_alloy_orche,1187,0,0,0,0
Mar 13 2011,Chris Peterson,Open Thread,http://mitadmissions.org/blogs/entry/open_thread,1187,0,0,0,0
Mar 12 2011,Elizabeth C. '13,Its the PI-nal countdown!,http://mitadmissions.org/blogs/entry/its_the_pinal_countdown,1188,0,0,0,0
Mar 11 2011,Rachel F. '12,Will the pie be bitter or sweet?,http://mitadmissions.org/blogs/entry/will_the_pie_be_bitter_or_swee,1189,0,0,0,0
Mar 11 2011,William Barton Rogers,Founders Letter,http://mitadmissions.org/blogs/entry/founders_letter,1189,0,0,0,0
Mar 10 2011,Mikey Yang '05,Pi(e),http://mitadmissions.org/blogs/entry/pie_2,1190,0,0,0,0
Mar 9 2011,Anna H. '14,I Challenge You,http://mitadmissions.org/blogs/entry/i_challenge_you,1191,2,3,14,19
Mar 9 2011,ROTC,AROTC Day in the Life,http://mitadmissions.org/blogs/entry/arotc_day_in_the_life,1191,0,1,0,1
Mar 9 2011,Kim Hunter '86,My How Times Change,http://mitadmissions.org/blogs/entry/my_how_times_change_1,1191,0,0,0,0
Mar 8 2011,Hamsika C. '13,Life + Sciences,http://mitadmissions.org/blogs/entry/life_science_1,1192,0,0,0,0
Mar 8 2011,Chris Peterson,Math Women Rock,http://mitadmissions.org/blogs/entry/math_women_rock,1192,0,0,0,0
Mar 8 2011,Elijah T. '11 ,The Great Debate,http://mitadmissions.org/blogs/entry/the_great_debate,1192,0,0,0,0
Mar 7 2011,MITLeaks,Decision Date 2011,http://mitadmissions.org/blogs/entry/decision_date_2011,1193,3,5,2,10
Mar 7 2011,Emad T. '14,Things That Arent Studying,http://mitadmissions.org/blogs/entry/things_that_arent_studying,1193,0,0,0,0
Mar 4 2011,Rachel F. '12,Stress Management @ The MITstitvte,http://mitadmissions.org/blogs/entry/stress_management_the_mitstitv,1196,0,0,0,0
Mar 4 2011,Chris Peterson,Hot Crosswalk Buns,http://mitadmissions.org/blogs/entry/hot_crosswalk_buns,1196,0,0,0,0
Mar 4 2011,Cam T. '13,A Splash of color!,http://mitadmissions.org/blogs/entry/a_splash_of_color,1196,0,0,0,0
Mar 3 2011,ARTalk,Pulse 2011,http://mitadmissions.org/blogs/entry/pulse_2011,1197,0,0,0,0
Mar 3 2011,Kris Guay,Not so FAST,http://mitadmissions.org/blogs/entry/not_so_fast,1197,0,0,0,0
Mar 2 2011,Elizabeth C. '13,If you give a girl an assignment,http://mitadmissions.org/blogs/entry/if_you_give_a_girl_an_assignme,1198,0,0,0,0
Mar 1 2011,Chris Peterson,Greetings from MIT Labs!,http://mitadmissions.org/blogs/entry/greetings_from_mit_labs_1,1199,0,0,0,0
Mar 1 2011,Chris S. '11,We All Need A Little Encouragement,http://mitadmissions.org/blogs/entry/we_all_need_a_little_encourage,1199,0,0,0,0
Feb 28 2011,Elijah T. '11 ,Final Forty-Five,http://mitadmissions.org/blogs/entry/final_fortyfive,1200,0,1,0,1
Feb 28 2011,Chris M. '12,The Future Is Grim,http://mitadmissions.org/blogs/entry/the_future_is_grim,1200,1,0,0,1
Feb 27 2011,Rachel F. '12,How Wrestling With Snapping Turtles Can Get You Into MIT,http://mitadmissions.org/blogs/entry/how_wrestling_with_snapping_tu,1201,1,4,1,6
Feb 27 2011,Chris Peterson,Meet TOFU,http://mitadmissions.org/blogs/entry/meet_tofu,1201,0,0,0,0
Feb 23 2011,Rachel F. '12,When The Omnipotent Hand Of Google Fails You,http://mitadmissions.org/blogs/entry/when_the_omnipotent_hand_of_go,1205,0,0,0,0
Feb 22 2011,Jenny X. '13,Fact: Architecture majors have to code,http://mitadmissions.org/blogs/entry/fact_architecture_majors_have,1206,0,1,0,1
Feb 21 2011,Quinton McArthur,NSBE MUSE Colloquium,http://mitadmissions.org/blogs/entry/nsbe_muse_colloquium,1207,0,0,0,0
Feb 18 2011,Maggie L. '12,Preparing for the real world,http://mitadmissions.org/blogs/entry/preparing_for_the_real_world,1210,0,0,0,0
Feb 16 2011,Financial Aid,It is not too late to begin applying for aid!,http://mitadmissions.org/blogs/entry/it_is_not_too_late_to_begin_ap,1212,0,0,0,0
Feb 15 2011,Hamsika C. '13,Dell-icious.,http://mitadmissions.org/blogs/entry/dellicious,1213,0,0,0,0
Feb 15 2011,Elizabeth C. '13,Life On Mars,http://mitadmissions.org/blogs/entry/life_on_mars,1213,0,0,0,0
Feb 15 2011,Anna H. '14,Academic Love Poetry,http://mitadmissions.org/blogs/entry/academic_love_poetry,1213,0,0,0,0
Feb 14 2011,Mikey Yang '05,Too Good to Just Tweet About,http://mitadmissions.org/blogs/entry/too_good_to_just_tweet_about,1214,0,0,0,0
Feb 14 2011,Rachel F. '12,Yestermonths IAP,http://mitadmissions.org/blogs/entry/yestermonths_iap,1214,0,0,0,0
Feb 13 2011,Emad T. '14,The First Year (In Numbers),http://mitadmissions.org/blogs/entry/the_first_year_in_numbers,1215,0,0,0,0
Feb 12 2011,Maggie L. '12,Most delicious deliverables ever,http://mitadmissions.org/blogs/entry/most_delicious_deliverables_ev,1216,0,0,0,0
Feb 11 2011,Hamsika C. '13,Put a Ring On It,http://mitadmissions.org/blogs/entry/put_a_ring_on_it,1217,0,0,0,0
Feb 11 2011,Elijah T. '11 ,More at Home,http://mitadmissions.org/blogs/entry/more_at_home,1217,0,0,0,0
Feb 11 2011,Emad T. '14,MIT International,http://mitadmissions.org/blogs/entry/mit_international,1217,0,0,0,0
Feb 10 2011,Matt McGann '00,Bringing Down the (Lottery) House,http://mitadmissions.org/blogs/entry/bringing_down_the_lottery_hous,1218,0,0,0,0
Feb 10 2011,Rachel F. '12,A Cacophony of Coats,http://mitadmissions.org/blogs/entry/a_cacophony_of_coats,1218,0,0,0,0
Feb 9 2011,Cydnie T. '12,Oh The Things Ive Seen,http://mitadmissions.org/blogs/entry/oh_the_things_ive_seen,1219,0,0,0,0
Feb 9 2011,Rachel F. '12,A Blogographical Biography,http://mitadmissions.org/blogs/entry/a_blogographical_biography,1219,0,0,0,0
Feb 8 2011,Chris Peterson,No Chance,http://mitadmissions.org/blogs/entry/no_chance,1220,27,6,6,39
Feb 8 2011,Hamsika C. '13,Womens Initiative,http://mitadmissions.org/blogs/entry/womens_initiative,1220,0,0,0,0
Feb 8 2011,Maggie L. '12,And now your feature presentation,http://mitadmissions.org/blogs/entry/and_now_your_feature_presentat,1220,0,0,0,0
Feb 7 2011,Quinton McArthur,Three from MIT!,http://mitadmissions.org/blogs/entry/three_from_mit_1,1221,0,0,0,0
Feb 7 2011,Kate R. '14,A Physics Metaphor,http://mitadmissions.org/blogs/entry/a_physics_metaphor,1221,0,0,0,0
Feb 3 2011,Maggie L. '12,V&Q&A,http://mitadmissions.org/blogs/entry/vqa_1,1225,0,0,0,0
Feb 3 2011,Elizabeth C. '13,We now interrupt our regularly-scheduled programming,http://mitadmissions.org/blogs/entry/we_now_interrupt_our_regularly,1225,0,0,0,0
Feb 1 2011,Alina G. '11,Me again (but with flamethrowers this time),http://mitadmissions.org/blogs/entry/me_again_but_with_flamethrower,1227,0,0,0,0
Jan 30 2011,Alina G. '11,Senior Spring!,http://mitadmissions.org/blogs/entry/senior_spring_1,1229,0,0,0,0
Jan 28 2011,Chris M. '12,Photophobic,http://mitadmissions.org/blogs/entry/photophobic,1231,0,0,0,0
Jan 27 2011,Kate R. '14,This Blog Post is a Bad Idea,http://mitadmissions.org/blogs/entry/this_blog_post_is_a_bad_idea,1232,0,0,0,0
Jan 26 2011,Elizabeth C. '13,Odds n Ends,http://mitadmissions.org/blogs/entry/odds_n_ends,1233,0,0,0,0
Jan 25 2011,Matt McGann '00,The MIT Midyear Report,http://mitadmissions.org/blogs/entry/the_mit_midyear_report,1234,0,0,0,0
Jan 25 2011,Maggie L. '12,Survey says,http://mitadmissions.org/blogs/entry/survey_says,1234,0,0,0,0
Jan 23 2011,Hamsika C. '13,Back to School,http://mitadmissions.org/blogs/entry/back_to_school,1236,0,0,0,0
Jan 21 2011,Chris S. '11,In Which I Sound Like an Old Man,http://mitadmissions.org/blogs/entry/in_which_i_sound_like_a_old_ma,1238,0,0,0,0
Jan 20 2011,Anna H. '14,On Teaching and Learning,http://mitadmissions.org/blogs/entry/on_teaching_and_learning,1239,3,1,0,4
Jan 20 2011,Emad T. '14,mit.wikipedia.org,http://mitadmissions.org/blogs/entry/mitwikipediaorg_1,1239,0,1,0,1
Jan 18 2011,Yan Z. '12,Mr. E. Hunt,http://mitadmissions.org/blogs/entry/mr_e_hunt,1241,0,0,0,0
Jan 18 2011,Cydnie T. '12,Snowy Birthday Party,http://mitadmissions.org/blogs/entry/snowy_birthday_party_1,1241,0,0,0,0
Jan 15 2011,Jenny X. '13,Snowpeople & a hammershark,http://mitadmissions.org/blogs/entry/snowpeople_a_hammershark,1244,0,0,0,0
Jan 11 2011,Emad T. '14,How to Survive a Noreaster,http://mitadmissions.org/blogs/entry/how_to_survive_a_noreaster,1248,0,0,0,0
Jan 10 2011,Maggie L. '12,Spaghettuna and Lego aircraft,http://mitadmissions.org/blogs/entry/spaghettuna_and_lego_aircraft,1249,0,0,0,0
Jan 7 2011,Chris Peterson,"Admissions Bulletin - RA News, EA Results",http://mitadmissions.org/blogs/entry/admissions_bulletin_ra_news_ea,1252,1,1,0,2
Jan 3 2011,Anna H. '14,Alan Guth and Day 1 on the Navajo Reservation,http://mitadmissions.org/blogs/entry/alan_guth_and_a_navajo_reserva,1256,1,2,2,5
Jan 3 2011,Elizabeth C. '13,Oodles Of Doodles,http://mitadmissions.org/blogs/entry/oodles_of_doodles_1,1256,0,0,0,0
Jan 1 2011,Hamsika C. '13,"A New Time, A New Place",http://mitadmissions.org/blogs/entry/a_new_time_a_new_place,1258,0,0,0,0
Dec 31 2010,Jenny X. '13,Happy New Year!,http://mitadmissions.org/blogs/entry/happy_new_year_2,1259,0,0,0,0
Dec 29 2010,Matt McGann '00,MIT Regular Action Deadline,http://mitadmissions.org/blogs/entry/mit_regular_action_deadline_2,1261,1,0,0,1
Dec 29 2010,Matt McGann '00,For EA Deferred Students,http://mitadmissions.org/blogs/entry/for_ea_deferred_students_2,1261,0,0,0,0
Dec 22 2010,Elizabeth C. '13,In Which I Get Schooled By My Professor,http://mitadmissions.org/blogs/entry/in_which_i_get_schooled_by_my,1268,0,0,0,0
Dec 22 2010,Emad T. '14,A Welcoming Environment,http://mitadmissions.org/blogs/entry/a_welcoming_environment,1268,0,0,0,0
Dec 16 2010,Decisions,Early Action: Decisions Now Available,http://mitadmissions.org/blogs/entry/early_action_decisions_2,1274,0,0,0,0
Dec 16 2010,Decisions,Early Action: Admitted,http://mitadmissions.org/blogs/entry/early_action_admitted,1274,0,0,0,0
Dec 16 2010,Decisions,Early Action: Deferred,http://mitadmissions.org/blogs/entry/early_action_deferred,1274,0,0,0,0
Dec 16 2010,Decisions,Early Action: Not Admitted,http://mitadmissions.org/blogs/entry/early_action_not_admitted,1274,0,0,0,0
Dec 14 2010,Chris Peterson,Minecraft: Discuss,http://mitadmissions.org/blogs/entry/minecraft_discuss,1276,0,0,0,0
Dec 12 2010,Chris S. '11,MIT = The American Dream,http://mitadmissions.org/blogs/entry/mit_the_american_dream,1278,0,0,0,0
Dec 12 2010,Jenny X. '13,a rose is a rose is a rose,http://mitadmissions.org/blogs/entry/a_rose_is_a_rose_is_a_rose,1278,0,0,0,0
Dec 10 2010,Elijah T. '11 ,Challenge Accepted,http://mitadmissions.org/blogs/entry/challenge_accepted,1280,2,2,3,7
Dec 10 2010,Matt McGann '00,"MIT EA Decisions: Thursday 12/16, 9pm EST",http://mitadmissions.org/blogs/entry/mit_ea_decisions_thursday_1216,1280,0,0,0,0
Dec 9 2010,Hamsika C. '13,Finality,http://mitadmissions.org/blogs/entry/finality,1281,0,0,0,0
Dec 9 2010,Chris M. '12,What do you do for fun around here?,http://mitadmissions.org/blogs/entry/what_do_you_do_for_fun_around,1281,0,0,0,0
Dec 7 2010,Kate R. '14,I THINK its time for a guest blog!,http://mitadmissions.org/blogs/entry/i_think_its_time_for_a_guest_b_1,1283,0,0,0,0
Dec 5 2010,Elizabeth C. '13,Flat Ryans Adventures at MIT!,http://mitadmissions.org/blogs/entry/flat_ryans_adventures_at_mit,1285,0,0,0,0
Dec 4 2010,Chris S. '11,MIT History Makes MIT Spotlight!,http://mitadmissions.org/blogs/entry/mit_history_makes_mit_spotligh,1286,0,0,0,0
Dec 1 2010,Emad T. '14,Take a Load Off,http://mitadmissions.org/blogs/entry/take_a_load_off_1,1289,0,0,0,0
Dec 1 2010,Chris M. '12,"Beard today, gone tomorrow",http://mitadmissions.org/blogs/entry/beard_today_gone_tomorrow_1,1289,1,5,14,20
Nov 27 2010,Alina G. '11,Nationals!,http://mitadmissions.org/blogs/entry/nationals,1293,0,0,0,0
Nov 25 2010,Elizabeth C. '13,Happy Thanksgiving,http://mitadmissions.org/blogs/entry/happy_thanksgiving_3,1295,0,0,0,0
Nov 24 2010,Emad T. '14,Moves and Music(als),http://mitadmissions.org/blogs/entry/moves_and_musicals,1296,0,0,0,0
Nov 23 2010,Anna H. '14,Help!,http://mitadmissions.org/blogs/entry/help,1297,0,1,0,1
Nov 23 2010,Cydnie T. '12,Weekend Adventures Part One,http://mitadmissions.org/blogs/entry/weekend_adventures_part_one,1297,0,0,0,0
Nov 22 2010,Elizabeth C. '13,Just Chillax [about your college essays],http://mitadmissions.org/blogs/entry/just_chillax_about_your_colleg,1298,0,1,0,1
Nov 21 2010,Elijah T. '11 ,Talking About Dining,http://mitadmissions.org/blogs/entry/talking_about_dining,1299,0,0,0,0
Nov 21 2010,Matt McGann '00,"Congrats Jenn Lai 11, Rhodes Scholar",http://mitadmissions.org/blogs/entry/congrats_jenn_lai_11_rhodes_sc,1299,0,0,0,0
Nov 20 2010,Hamsika C. '13,298 Tickets.,http://mitadmissions.org/blogs/entry/298_tickets,1300,0,0,0,0
Nov 18 2010,Matt McGann '00,Early Action Update,http://mitadmissions.org/blogs/entry/early_action_update,1302,0,0,0,0
Nov 14 2010,Maggie L. '12,Feedback Works,http://mitadmissions.org/blogs/entry/feedback_works,1306,0,2,1,3
Nov 14 2010,Chris Peterson,Watch a Webcast!,http://mitadmissions.org/blogs/entry/watch_a_webcast,1306,0,0,0,0
Nov 13 2010,Anna H. '14,SpaceVision 2010,http://mitadmissions.org/blogs/entry/spacevision_2010,1307,0,0,0,0
Nov 10 2010,Elizabeth C. '13,Youve got questions,http://mitadmissions.org/blogs/entry/youve_got_questions_1,1310,0,0,0,0
Nov 10 2010,Matt McGann '00,Missing Application Materials?,http://mitadmissions.org/blogs/entry/missing_application_materials,1310,0,0,0,0
Nov 4 2010,Jenny X. '13,Anyone else OCD about saving space??,http://mitadmissions.org/blogs/entry/anyone_else_ocd_about_saving_s,1316,0,0,0,0
Nov 4 2010,Maggie L. '12,How to Teach Leadership,http://mitadmissions.org/blogs/entry/how_to_teach_leadership,1316,0,0,0,0
Nov 3 2010,Chris M. '12,Odds and Ends,http://mitadmissions.org/blogs/entry/odds_and_ends_1,1317,0,1,0,1
Nov 2 2010,Cydnie T. '12,Life as an Artist,http://mitadmissions.org/blogs/entry/life_as_an_artist,1318,0,0,0,0
Nov 1 2010,Elijah T. '11 ,Restoring Sanity and Fear,http://mitadmissions.org/blogs/entry/restoring_sanity_and_fear,1319,0,0,0,0
Nov 1 2010,Hamsika C. '13,MIA No More,http://mitadmissions.org/blogs/entry/mia_no_more,1319,0,0,0,0
Nov 1 2010,Chris Peterson,Applying Sideways,http://mitadmissions.org/blogs/entry/applying_sideways,1319,130,85,50,265
Oct 31 2010,Cam T. '13,Scary Tails and College Essays,http://mitadmissions.org/blogs/entry/scary_tails_and_college_essays,1320,0,0,0,0
Oct 30 2010,Chris S. '11,My Second Home,http://mitadmissions.org/blogs/entry/my_second_home,1321,0,0,0,0
Oct 29 2010,Matt McGann '00,Your Early Action Deadline Questions,http://mitadmissions.org/blogs/entry/your_early_action_deadline_que,1322,2,1,0,3
Oct 29 2010,Emad T. '14,Defying That Sinking Feeling,http://mitadmissions.org/blogs/entry/defying_that_sinking_feeling_1,1322,2,0,0,2
Oct 28 2010,Anna H. '14,"Ode to the New, Part 3",http://mitadmissions.org/blogs/entry/ode_to_the_new_part_3,1323,0,0,0,0
Oct 28 2010,Elizabeth C. '13,Outside The Bubble,http://mitadmissions.org/blogs/entry/outside_the_bubble,1323,0,0,0,0
Oct 28 2010,Kate R. '14,Fall Hits MIT in the form of a Giant Spider!,http://mitadmissions.org/blogs/entry/fall_hits_mit_in_the_form_of_a,1323,0,0,0,0
Oct 27 2010,Kate R. '14,Fall Hits MIT,http://mitadmissions.org/blogs/entry/fall_hits_mit,1324,0,0,0,0
Oct 24 2010,Kate R. '14,The Rudolph Family Weekend,http://mitadmissions.org/blogs/entry/the_rudolph_family_weekend,1327,0,0,0,0
Oct 22 2010,Cam T. '13,I Love Lucy: Continued,http://mitadmissions.org/blogs/entry/i_love_lucy_continued,1329,0,0,0,0
Oct 19 2010,Elijah T. '11 ,"Most Importantly, No Reddit",http://mitadmissions.org/blogs/entry/most_importantly_no_reddit,1332,0,0,0,0
Oct 19 2010,Chris Peterson,Live from the Glass Lab!,http://mitadmissions.org/blogs/entry/live_from_the_glass_lab,1332,0,0,0,0
Oct 19 2010,Emad T. '14,Human After All,http://mitadmissions.org/blogs/entry/human_after_all,1332,0,0,0,0
Oct 18 2010,Cydnie T. '12,Fariborz Maseeh Hall,http://mitadmissions.org/blogs/entry/fariborz_maseeh_hall,1333,0,0,0,0
Oct 18 2010,Matt McGann '00,MIT Econ Prof Wins Nobel Prize (with video),http://mitadmissions.org/blogs/entry/mit_econ_prof_wins_nobel_prize,1333,0,0,0,0
Oct 16 2010,Matt McGann '00,About MIT Recommendation Letters,http://mitadmissions.org/blogs/entry/about_mit_recommendation_lette,1335,0,0,0,0
Oct 15 2010,Emad T. '14,Living Like A Native,http://mitadmissions.org/blogs/entry/hitting_town_hitting_the_books,1336,0,0,0,0
Oct 14 2010,Natanya K. '14,On Mens et Manus,http://mitadmissions.org/blogs/entry/on_mens_et_manus_1,1337,0,0,0,0
Oct 13 2010,Cam T. '13,I Love Lucy!,http://mitadmissions.org/blogs/entry/i_love_lucy,1338,0,0,0,0
Oct 13 2010,Quinton McArthur,Terrible Traffic,http://mitadmissions.org/blogs/entry/terrible_traffic_1,1338,0,0,0,0
Oct 13 2010,Shannon M. '12,"Science, Technology, and Elephants.",http://mitadmissions.org/blogs/entry/science_technology_and_elephan,1338,0,0,0,0
Oct 12 2010,Elijah T. '11 ,North to Peru,http://mitadmissions.org/blogs/entry/north_to_peru,1339,0,0,0,0
Oct 12 2010,Maggie L. '12,Weekend Off,http://mitadmissions.org/blogs/entry/weekend_off_1,1339,0,0,0,0
Oct 11 2010,Natanya K. '14,RainbowFloor@MIT,http://mitadmissions.org/blogs/entry/rainbowfloormit,1340,0,0,0,0
Oct 11 2010,Chris Peterson,18 and Counting,http://mitadmissions.org/blogs/entry/18_and_mit,1340,0,0,0,0
Oct 10 2010,Elizabeth C. '13,There are a lot of awesome things named Kaiser,http://mitadmissions.org/blogs/entry/there_are_a_lot_of_awesome_thi,1341,6,6,1,13
Oct 10 2010,Chris Peterson,Get It Done,http://mitadmissions.org/blogs/entry/get_it_done,1341,0,0,0,0
Oct 9 2010,Hamsika C. '13,Sentimentality,http://mitadmissions.org/blogs/entry/sentimentality,1342,0,0,0,0
Oct 9 2010,Anna H. '14,"Ode to the New, Part 2",http://mitadmissions.org/blogs/entry/ode_to_the_new_part_2,1342,0,0,0,0
Oct 8 2010,Elijah T. '11 ,An Open Letter,http://mitadmissions.org/blogs/entry/an_open_letter,1343,0,0,0,0
Oct 7 2010,Kate R. '14,An Adventure on the Charles,http://mitadmissions.org/blogs/entry/an_adventure_on_the_charles,1344,0,0,0,0
Oct 7 2010,Chris Peterson,MIT Women Rock,http://mitadmissions.org/blogs/entry/mit_women_rock,1344,0,0,0,0
Oct 5 2010,Kate R. '14,Test Time!,http://mitadmissions.org/blogs/entry/test_time,1346,0,0,0,0
Oct 4 2010,Mikey Yang '05,On the Road Again,http://mitadmissions.org/blogs/entry/on_the_road_again,1347,0,0,0,0
Oct 4 2010,Cydnie T. '12,iCyd,http://mitadmissions.org/blogs/entry/icyd,1347,0,0,0,0
Oct 4 2010,Chris M. '12,Perkus Nonacademia,http://mitadmissions.org/blogs/entry/perkus_nonacademia,1347,0,1,0,1
Sep 30 2010,Jenny X. '13,Diary of an All-nighter,http://mitadmissions.org/blogs/entry/diary_of_an_allnighter,1351,0,0,0,0
Sep 30 2010,Kate R. '14,"Swag ... I mean, Career Fair",http://mitadmissions.org/blogs/entry/swag_i_mean_career_fair,1351,0,0,0,0
Sep 28 2010,Anna H. '14,"Ode to the New, Part 1",http://mitadmissions.org/blogs/entry/ode_to_the_new_part_1_1,1353,1,0,0,1
Sep 28 2010,Maggie L. '12,Ye Olde Career Fair,http://mitadmissions.org/blogs/entry/ye_olde_career_fair,1353,0,0,0,0
Sep 27 2010,ARTalk,MIT Arts Party 2010!,http://mitadmissions.org/blogs/entry/mit_arts_party_2010_1,1354,0,0,0,0
Sep 26 2010,Hamsika C. '13,Sailing!,http://mitadmissions.org/blogs/entry/sailing,1355,0,0,0,0
Sep 26 2010,Chris S. '11,A Preview of Things to Come,http://mitadmissions.org/blogs/entry/a_preview_of_things_to_come,1355,0,0,0,0
Sep 24 2010,Chris Peterson,Blast From The Past: Garage Hero!,http://mitadmissions.org/blogs/entry/blast_from_the_past_garage_her,1357,0,0,0,0
Sep 23 2010,Elizabeth C. '13,On Being a n00b at MIT,http://mitadmissions.org/blogs/entry/on_being_a_n00b_at_mit,1358,0,0,0,0
Sep 23 2010,Matt McGann '00,Watch this!,http://mitadmissions.org/blogs/entry/watch_this,1358,0,0,0,0
Sep 21 2010,Hamsika C. '13,Stayin Classy,http://mitadmissions.org/blogs/entry/stayin_classy,1360,0,0,0,0
Sep 20 2010,Alina G. '11,"MIT XC, looking sharp",http://mitadmissions.org/blogs/entry/mit_xc_looking_sharp_1,1361,0,0,0,0
Sep 20 2010,Emad T. '14,3D Ping Pong Quantum Mechanics,http://mitadmissions.org/blogs/entry/3d_ping_pong_quantum_mechanics,1361,1,0,0,1
Sep 19 2010,Kate R. '14,Happy Birthday!,http://mitadmissions.org/blogs/entry/happy_birthday,1362,0,0,0,0
Sep 19 2010,Cam T. '13,Misery Loves Company: Part 1,http://mitadmissions.org/blogs/entry/misery_loves_company_part_1,1362,0,0,0,0
Sep 18 2010,Elijah T. '11 ,The New Year,http://mitadmissions.org/blogs/entry/the_new_year,1363,0,0,0,0
Sep 18 2010,Natanya K. '14,Enterlude,http://mitadmissions.org/blogs/entry/enterlude,1363,0,0,0,0
Sep 17 2010,Elizabeth C. '13,Just A Small Town Girl,http://mitadmissions.org/blogs/entry/just_a_small_town_girl,1364,0,0,0,0
Sep 17 2010,Anna H. '14,Making an Entrance,http://mitadmissions.org/blogs/entry/making_an_entrance,1364,2,0,0,2
Sep 17 2010,Kate R. '14,Apple Juice Liberation!,http://mitadmissions.org/blogs/entry/apple_juice_liberation,1364,0,0,0,0
Sep 14 2010,Chris Peterson,Inside the Webcast Studio,http://mitadmissions.org/blogs/entry/inside_the_webcast_studio,1367,2,0,0,2
Sep 13 2010,Celena C. '12,Just a little hack,http://mitadmissions.org/blogs/entry/just_a_little_hack,1368,0,0,0,0
Sep 13 2010,Dave McOwen,Coffee Talk,http://mitadmissions.org/blogs/entry/coffee_talk,1368,0,0,0,0
Sep 11 2010,Matt McGann '00,MIT on the road,http://mitadmissions.org/blogs/entry/mit_on_the_road,1370,0,0,0,0
Sep 10 2010,Dave McOwen,Opera,http://mitadmissions.org/blogs/entry/opera,1371,0,0,0,0
Sep 9 2010,Chris S. '11,What YOURE Doing This Summer! (2010 Edition!),http://mitadmissions.org/blogs/entry/what_youre_doing_this_summer_2,1372,0,0,0,0
Sep 8 2010,Matt McGann '00,First Day of Classes!,http://mitadmissions.org/blogs/entry/first_day_of_classes_2,1373,0,0,0,0
Sep 6 2010,Kim Hunter '86,Scheduling Your Interview,http://mitadmissions.org/blogs/entry/scheduling_your_interview,1375,0,0,0,0
Sep 5 2010,Chris Peterson,Art Imitating Art,http://mitadmissions.org/blogs/entry/art_imitating_art,1376,0,0,0,0
Sep 1 2010,Hamsika C. '13,Withdrawal Symptoms,http://mitadmissions.org/blogs/entry/withdrawal_symptoms,1380,0,0,0,0
Sep 1 2010,Dave McOwen,Orientation,http://mitadmissions.org/blogs/entry/orientation,1380,0,0,0,0
Aug 30 2010,Celena C. '12,Like Never Before,http://mitadmissions.org/blogs/entry/like_never_before,1382,0,0,0,0
Aug 26 2010,Mikey Yang '05,"Tweet, tweet",http://mitadmissions.org/blogs/entry/tweet_tweet,1386,0,0,0,0
Aug 26 2010,Maggie L. '12,Its Almost Here!,http://mitadmissions.org/blogs/entry/upop_orientation,1386,0,0,0,0
Aug 26 2010,Dave McOwen,(un)Empty Nest,http://mitadmissions.org/blogs/entry/unempty_nest,1386,0,0,0,0
Aug 25 2010,Chris Peterson,Nerd Love,http://mitadmissions.org/blogs/entry/nerds_need_love_too,1387,0,0,0,0
Aug 23 2010,Matt McGann '00,Famous people who didnt go to MIT,http://mitadmissions.org/blogs/entry/famous_people_who_didnt_go_to,1389,3,4,0,7
Aug 20 2010,Hamsika C. '13,Settled,http://mitadmissions.org/blogs/entry/settled,1392,0,0,0,0
Aug 17 2010,Jenny X. '13,"Hello, Goodbye,",http://mitadmissions.org/blogs/entry/hello_goodbye,1395,0,0,0,0
Aug 17 2010,Elijah T. '11 ,Checking My Calendar,http://mitadmissions.org/blogs/entry/checking_my_calendar,1395,0,0,0,0
Aug 16 2010,Chris Peterson,Announcing New Bloggers for 2010!,http://mitadmissions.org/blogs/entry/announcing_new_bloggers_for_20,1396,0,0,0,0
Aug 15 2010,Maggie L. '12,"Veni, Vidi, Jamba",http://mitadmissions.org/blogs/entry/veni_vidi_jamba,1397,0,0,0,0
Aug 10 2010,Matt McGann '00,The MIT Application is now available!,http://mitadmissions.org/blogs/entry/the_mit_application_is_now_ava,1402,2,1,0,3
Aug 10 2010,Matt McGann '00,Talking about a difficult subject,http://mitadmissions.org/blogs/entry/talking_about_a_difficult_subj,1402,0,1,1,2
Aug 10 2010,Cydnie T. '12,3-D Blog!!,http://mitadmissions.org/blogs/entry/3d_blog_1,1402,0,0,0,0
Aug 10 2010,Chris S. '11,What Are YOU Up To This Summer?! (2010 Edition),http://mitadmissions.org/blogs/entry/what_are_you_up_to_this_summer_1,1402,0,0,0,0
Aug 9 2010,Chris Peterson,Do You Like Like?,http://mitadmissions.org/blogs/entry/do_you_like_like,1403,0,0,0,0
Aug 6 2010,Cam T. '13,hello from seattle,http://mitadmissions.org/blogs/entry/hello_from_seattle,1406,0,0,0,0
Aug 5 2010,Kim Hunter '86,Undercover Admissions Officer,http://mitadmissions.org/blogs/entry/undercover_admissions_officer_1,1407,0,0,0,0
Aug 4 2010,Chris Peterson,Gallivanting with Gilles,http://mitadmissions.org/blogs/entry/gallavanting_with_gilles,1408,0,0,0,0
Aug 2 2010,Elijah T. '11 ,Into the Smoke,http://mitadmissions.org/blogs/entry/into_the_smoke_1,1410,0,0,0,0
Aug 2 2010,Hamsika C. '13,Belated,http://mitadmissions.org/blogs/entry/another_travel_story,1410,3,0,0,3
Jul 31 2010,Jenny X. '13,All Hail the Working People,http://mitadmissions.org/blogs/entry/all_hail_the_working_people,1412,0,0,0,0
Jul 29 2010,Chris M. '12,The Institute of Smashing,http://mitadmissions.org/blogs/entry/the_institute_of_smashing_1,1414,3,2,0,5
Jul 28 2010,Chris Peterson,"Alaska, part I",http://mitadmissions.org/blogs/entry/alaska_part_i,1415,0,0,0,0
Jul 26 2010,Alina G. '11,Katharine Hepburns Brownies,http://mitadmissions.org/blogs/entry/katharine_hepburns_brownies_1,1417,0,0,0,0
Jul 26 2010,Keri G. '10,In which I screwed up a lot,http://mitadmissions.org/blogs/entry/in_which_i_screwed_up_a_lot,1417,0,0,0,0
Jul 23 2010,Chris S. '11,Complementary in Kinetic Typography,http://mitadmissions.org/blogs/entry/complementary_in_kinetic_typog,1420,0,0,0,0
Jul 22 2010,Quinton McArthur,Summertime,http://mitadmissions.org/blogs/entry/summertime_1,1421,0,0,0,0
Jul 20 2010,Maggie L. '12,Bumping Up Againstand Breaking Throughthe Glass Ceiling,http://mitadmissions.org/blogs/entry/glass_ceiling,1423,0,0,0,0
Jul 19 2010,Hamsika C. '13,~*~Thoughts Are Like Traces of Birds In Heaven~*~,http://mitadmissions.org/blogs/entry/thoughts_are_like_traces_of_bi_1,1424,0,0,0,0
Jul 19 2010,Financial Aid,Your MIT Bill!,http://mitadmissions.org/blogs/entry/your_mit_bill,1424,0,0,0,0
Jul 18 2010,Shannon M. '12,A Pythagorean Triple of Awesome,http://mitadmissions.org/blogs/entry/a_pythagorean_triple_of_awesom,1425,0,0,0,0
Jul 14 2010,Alina G. '11,I saw a turkey the other day,http://mitadmissions.org/blogs/entry/i_saw_a_turkey_the_other_day,1429,0,0,0,0
Jul 14 2010,Quinton McArthur,Judd Logan is my homeboy,http://mitadmissions.org/blogs/entry/judd_logan_is_my_homeboy_1,1429,0,0,0,0
Jul 13 2010,Maggie L. '12,Lea-der! Lea-der! Bat-man!,http://mitadmissions.org/blogs/entry/women_leaders,1430,0,0,0,0
Jul 7 2010,Chris M. '12,Summer Circus,http://mitadmissions.org/blogs/entry/summer_circus,1436,0,0,0,0
Jul 7 2010,Chris Peterson,Blogger Application 2010,http://mitadmissions.org/blogs/entry/blogger_application_2010,1436,0,2,0,2
Jul 5 2010,Jenny X. '13,Inside/Outside,http://mitadmissions.org/blogs/entry/insideoutside,1438,0,0,0,0
Jul 1 2010,Yan Z. '12,This Entry is About,http://mitadmissions.org/blogs/entry/this_entry_is_about,1442,0,0,0,0
Jun 30 2010,Cam T. '13,One Year After Michael Jackson,http://mitadmissions.org/blogs/entry/one_year_after_michael_jackson,1443,0,0,0,0
Jun 28 2010,Hamsika C. '13,This Entry is Really Long.,http://mitadmissions.org/blogs/entry/this_entry_is_really_long,1445,1,0,0,1
Jun 27 2010,Chris S. '11,Im in New York!,http://mitadmissions.org/blogs/entry/im_in_new_york_1,1446,0,0,0,0
Jun 23 2010,ARTalk,Orthostatic Tolerance,http://mitadmissions.org/blogs/entry/orthostatic_tolerance,1450,0,2,0,2
Jun 16 2010,Matt McGann '00,MIT Alums Direct New OK Go Video,http://mitadmissions.org/blogs/entry/mit_alums_direct_new_ok_go_vid,1457,4,4,2,10
Jun 15 2010,Hamsika C. '13,Ich Liebe Deutschland!,http://mitadmissions.org/blogs/entry/ich_liebe_deutschland,1458,1,0,0,1
Jun 14 2010,Maggie L. '12,GEL-ing,http://mitadmissions.org/blogs/entry/geling,1459,0,0,0,0
Jun 10 2010,Chris M. '12,The ________ Outdoors,http://mitadmissions.org/blogs/entry/the__________outdoors,1463,0,0,0,0
Jun 9 2010,Matt McGann '00,"MIT grads, 10 years later",http://mitadmissions.org/blogs/entry/mit_grads_10_years_later,1464,3,1,0,4
Jun 8 2010,Jess K. '10,Things I Never Finished,http://mitadmissions.org/blogs/entry/things_i_never_finished_part_1,1465,0,0,0,0
Jun 3 2010,Hamsika C. '13,Ich Spreche Kein Deutsch.,http://mitadmissions.org/blogs/entry/ich_spreche_kein_deutsch,1470,1,0,0,1
Jun 2 2010,Chris Peterson,Biking in Boston,http://mitadmissions.org/blogs/entry/biking_in_boston,1471,0,0,0,0
May 27 2010,Keri G. '10,Things Wot I Did Whilst Studying at MIT,http://mitadmissions.org/blogs/entry/things_wot_i_have_learned_whil,1477,0,0,0,0
May 27 2010,Chris S. '11,The Magic of Those Ivory Keys (Guest Blog!),http://mitadmissions.org/blogs/entry/the_magic_of_those_ivory_keys,1477,0,0,0,0
May 25 2010,Jess K. '10,Its here!,http://mitadmissions.org/blogs/entry/its_here,1479,0,0,0,0
May 25 2010,Hamsika C. '13,Retrospective,http://mitadmissions.org/blogs/entry/retrospective,1479,1,0,0,1
May 24 2010,Chris S. '11,The View From the Other Side of Hell,http://mitadmissions.org/blogs/entry/the_view_from_the_other_side_o,1480,0,0,0,0
May 24 2010,ARTalk,Schnitzer Prize Winners!,http://mitadmissions.org/blogs/entry/schnitzer_prize_winners,1480,0,0,0,0
May 21 2010,Keri G. '10,LOOK AT THIS.,http://mitadmissions.org/blogs/entry/look_at_this,1483,0,1,0,1
May 20 2010,Jess K. '10,Tying up some loose ends,http://mitadmissions.org/blogs/entry/tying_up_some_loose_ends,1484,0,0,0,0
May 17 2010,Snively '11,MIT Brings You Unwanted Attention,http://mitadmissions.org/blogs/entry/mit_brings_you_unwanted_attent,1487,1,0,0,1
May 16 2010,Dave McOwen,Engineers Assemble!,http://mitadmissions.org/blogs/entry/engineers_assemble,1488,0,0,0,0
May 13 2010,Dave McOwen,"The Waitlist, 2010",http://mitadmissions.org/blogs/entry/the_waitlist_2010,1491,0,0,0,0
May 12 2010,Jess K. '10,Glimpses of Haiti,http://mitadmissions.org/blogs/entry/glimpses_of_haiti,1492,0,0,0,0
May 6 2010,Hamsika C. '13,Refreshment,http://mitadmissions.org/blogs/entry/refreshment,1498,0,0,0,0
May 6 2010,Dave McOwen,Cool Toys II,http://mitadmissions.org/blogs/entry/cool_toys_ii,1498,0,0,0,0
May 4 2010,Dave McOwen,The home of cool toys,http://mitadmissions.org/blogs/entry/the_home_of_cool_toys,1500,0,0,0,0
May 4 2010,Chris S. '11,Welcome 2014s!! :),http://mitadmissions.org/blogs/entry/welcome_2014s,1500,0,0,0,0
May 3 2010,Chris M. '12,"Looked outside my window, and what did I see",http://mitadmissions.org/blogs/entry/looked_outside_my_window_and_w,1501,1,1,1,3
May 3 2010,ROTC,Whos that girl in uniform?,http://mitadmissions.org/blogs/entry/whos_that_girl_in_uniform,1501,0,0,0,0
May 2 2010,Celena C. '12,RING DELIVERY!!!,http://mitadmissions.org/blogs/entry/ring_delivery_2,1502,0,0,0,0
May 1 2010,Jess K. '10,Last night in Haiti,http://mitadmissions.org/blogs/entry/last_night_in_haiti,1503,0,0,0,0
Apr 30 2010,Dave McOwen,MTV,http://mitadmissions.org/blogs/entry/mtv_1,1504,0,0,0,0
Apr 30 2010,Jenny X. '13,Where Ive Been,http://mitadmissions.org/blogs/entry/where_ive_been,1504,0,0,0,0
Apr 28 2010,Keri G. '10,MIT and the SAA,http://mitadmissions.org/blogs/entry/mit_and_the_saa_1,1506,0,0,0,0
Apr 28 2010,Hamsika C. '13,Camp Kesem!,http://mitadmissions.org/blogs/entry/camp_kesem,1506,0,0,0,0
Apr 28 2010,Jess K. '10,Haiti Day 3: Koumon ou rele?,http://mitadmissions.org/blogs/entry/haiti_day_3_koumon_ou_rele,1506,0,0,0,0
Apr 27 2010,Jess K. '10,Haiti Day 2: DINEPA and mosquito bites,http://mitadmissions.org/blogs/entry/haiti_day_2_dinepa_and_mosquit,1507,0,0,0,0
Apr 26 2010,Chris Peterson,Notes From Atlanta,http://mitadmissions.org/blogs/entry/notes_from_atlanta,1508,0,0,0,0
Apr 26 2010,ARTalk,Gustavo Dudamel Conducts MITSO!,http://mitadmissions.org/blogs/entry/gustavo_dudamel_conducts_mitso,1508,0,0,0,0
Apr 25 2010,Jess K. '10,Haiti: Day 1,http://mitadmissions.org/blogs/entry/haiti_day_1,1509,0,0,0,0
Apr 23 2010,Chris S. '11,Blagoblagz*: Why Im a History Major at MIT (Guest Blog!),http://mitadmissions.org/blogs/entry/blagoblagz_why_im_a_history_ma,1511,0,0,0,0
Apr 22 2010,Quinton McArthur,"Decisions, Decisions..*sigh*",http://mitadmissions.org/blogs/entry/decisions_decisions_4,1512,0,0,0,0
Apr 21 2010,Hamsika C. '13,I Feel Cool,http://mitadmissions.org/blogs/entry/deaths_per_megawatt_and_other,1513,0,0,0,0
Apr 21 2010,Financial Aid,Your Financial Aid and Billing Questions Answered! (part 4),http://mitadmissions.org/blogs/entry/your_financial_aid_and_billing_3,1513,0,0,0,0
Apr 21 2010,Matt McGann '00,Saying Yes (or No),http://mitadmissions.org/blogs/entry/saying_yes_or_no,1513,0,2,0,2
Apr 21 2010,Matt McGann '00,On taking a Gap Year,http://mitadmissions.org/blogs/entry/on_taking_a_gap_year_1,1513,0,0,0,0
Apr 21 2010,Dave McOwen,Bill Gates,http://mitadmissions.org/blogs/entry/bill_gates,1513,0,0,0,0
Apr 20 2010,Financial Aid,Your Financial Aid and Billing Questions Answered! (part 3),http://mitadmissions.org/blogs/entry/your_financial_aid_and_billing_2,1514,0,0,0,0
Apr 18 2010,Hamsika C. '13,PresentingMy Prefrosh!,http://mitadmissions.org/blogs/entry/presentingmy_prefrosh,1516,0,1,1,2
Apr 18 2010,Chris S. '11,Burchard Scholars Program,http://mitadmissions.org/blogs/entry/burchard_scholars_program,1516,0,0,0,0
Apr 16 2010,Shannon M. '12,A Shot in the Life,http://mitadmissions.org/blogs/entry/unedited_screenshots,1518,0,0,0,0
Apr 16 2010,Financial Aid,Your Financial Aid and Billing Questions Answered! (part 2),http://mitadmissions.org/blogs/entry/your_financial_aid_and_billing_1,1518,0,0,0,0
Apr 16 2010,Cam T. '13,For Those About to Dew,http://mitadmissions.org/blogs/entry/for_those_about_to_dew,1518,0,0,0,0
Apr 15 2010,Financial Aid,Your Financial Aid and Billing Questions Answered! (part 1),http://mitadmissions.org/blogs/entry/your_financial_aid_and_billing,1519,0,0,0,0
Apr 14 2010,Chris S. '11,Sleep is Overrated (CPW Guest Blog!),http://mitadmissions.org/blogs/entry/sleep_is_overrated_cpw_guest_b,1520,2,1,3,6
Apr 13 2010,Chris S. '11,Musings on Colorful Balls (CPW Guest Blog!),http://mitadmissions.org/blogs/entry/musings_with_colorful_balls_cp,1521,0,0,0,0
Apr 11 2010,Chris S. '11,Share Your CPW With Us!,http://mitadmissions.org/blogs/entry/share_your_cpw_with_us,1523,0,0,0,0
Apr 10 2010,Hamsika C. '13,On the Flip Side,http://mitadmissions.org/blogs/entry/on_the_flip_side,1524,0,0,0,0
Apr 7 2010,Cam T. '13,Let the games begin!,http://mitadmissions.org/blogs/entry/let_the_games_begin,1527,0,0,0,0
Apr 7 2010,Mikey Yang '05,ZOMG CPW,http://mitadmissions.org/blogs/entry/zomg_cpw_1,1527,0,0,0,0
Apr 7 2010,Chris M. '12,Battle of the Bands,http://mitadmissions.org/blogs/entry/battle_of_the_bands,1527,0,0,0,0
Apr 7 2010,Financial Aid,CPW with SFS,http://mitadmissions.org/blogs/entry/cpw_with_sfs,1527,0,0,0,0
Apr 7 2010,Matt McGann '00,Q&A with Prof. Jonathan Gruber 87 (CPW Preview!),http://mitadmissions.org/blogs/entry/qa_with_prof_jonathan_gruber_8,1527,0,0,0,0
Apr 6 2010,Kim Hunter '86,The Parents Guide to CPW,http://mitadmissions.org/blogs/entry/post_23,1528,0,0,0,0
Apr 5 2010,Matt McGann '00,Q&A with Prof. Nancy Kanwisher 80 (CPW Preview!),http://mitadmissions.org/blogs/entry/qa_with_prof_nancy_kanwisher_8,1529,0,0,0,0
Apr 5 2010,Chris S. '11,CPW Events That You Should Come To!,http://mitadmissions.org/blogs/entry/cpw_events_that_you_should_com,1529,0,0,0,0
Apr 4 2010,Snively '11,Were Ready for CPW,http://mitadmissions.org/blogs/entry/were_ready_for_cpw,1530,0,0,0,0
Apr 4 2010,Chris M. '12,My New Hobby.,http://mitadmissions.org/blogs/entry/my_new_hobby,1530,0,0,0,0
Apr 2 2010,Chris Peterson,CPW on the Web,http://mitadmissions.org/blogs/entry/cpw_on_the_web,1532,0,2,0,2
Apr 2 2010,Hamsika C. '13,T-Minus Six Days,http://mitadmissions.org/blogs/entry/tminus_six_days,1532,0,0,0,0
Mar 30 2010,Jenny X. '13,Story of a Lifestyle,http://mitadmissions.org/blogs/entry/story_of_a_lifestyle,1535,0,0,0,0
Mar 29 2010,ARTalk,Building the Yearbook,http://mitadmissions.org/blogs/entry/building_the_yearbook,1536,0,0,0,0
Mar 27 2010,Yan Z. '12,40 Hours in Cape Cod,http://mitadmissions.org/blogs/entry/40_hours_in_cape_cod,1538,0,0,0,0
Mar 25 2010,Dave McOwen,Your friendly neighborhood webcaster,http://mitadmissions.org/blogs/entry/your_friendly_neighborhood_web,1540,0,0,0,0
Mar 22 2010,Dave McOwen,CPW,http://mitadmissions.org/blogs/entry/cpw,1543,0,0,0,0
Mar 21 2010,Kim D. '09,Are people on the East Coast friendly?,http://mitadmissions.org/blogs/entry/are_people_on_the_east_coast_f,1544,1,0,0,1
Mar 19 2010,Cristen C. '10,"Rejects, I feel your pain!",http://mitadmissions.org/blogs/entry/rejects_i_feel_your_pain,1546,0,0,0,0
Mar 18 2010,Cam T. '13,The MIT Blogarhythms!,http://mitadmissions.org/blogs/entry/the_mit_blogarhythms,1547,0,0,0,0
Mar 18 2010,Jess K. '10,"Share Your Story, 2014 edition",http://mitadmissions.org/blogs/entry/share_your_story_2014_edition,1547,1,0,0,1
Mar 18 2010,Matt McGann '00,Admitted Students Update,http://mitadmissions.org/blogs/entry/admitted_students_update_3,1547,0,0,0,0
Mar 18 2010,Matt McGann '00,More Information on the Waitlist,http://mitadmissions.org/blogs/entry/more_information_on_the_waitli_1,1547,0,0,0,0
Mar 17 2010,Snively '11,"Something is coming, part 3",http://mitadmissions.org/blogs/entry/something_is_coming_part_3,1548,0,0,0,0
Mar 17 2010,Kim Hunter '86,MIT Admitted Student Spring Meetings,http://mitadmissions.org/blogs/entry/mit_admitted_student_spring_me_1,1548,0,0,0,0
Mar 16 2010,Hamsika C. '13,Hello?,http://mitadmissions.org/blogs/entry/hello,1549,0,0,0,0
Mar 16 2010,Chris S. '11,Story of Tim Tebow,http://mitadmissions.org/blogs/entry/story_of_tim_tebow,1549,0,0,0,0
Mar 15 2010,ARTalk,MITSO Gone Wild!,http://mitadmissions.org/blogs/entry/mitso_gone_wild,1550,0,0,0,0
Mar 14 2010,Admin,MIT Regular Action Admissions Decisions available online,http://mitadmissions.org/blogs/entry/mit_regular_action_admissions_1,1551,0,0,0,0
Mar 14 2010,Admin,Open Forum for Admitted Students,http://mitadmissions.org/blogs/entry/open_forum_for_admitted_studen_1,1551,1,0,0,1
Mar 14 2010,Admin,Open Forum for Waitlisted Students,http://mitadmissions.org/blogs/entry/open_forum_for_waitlisted_stud_1,1551,0,0,0,0
Mar 14 2010,Admin,Open Forum for those Not Admitted,http://mitadmissions.org/blogs/entry/open_forum_for_those_not_admit_1,1551,0,0,0,0
Mar 14 2010,Hamsika C. '13,A Few Words,http://mitadmissions.org/blogs/entry/a_few_words,1551,0,0,0,0
Mar 14 2010,Snively '11,OMG OMG OMG!,http://mitadmissions.org/blogs/entry/omg_omg_omg,1551,0,0,0,0
Mar 13 2010,Jess K. '10,"Something is coming, part 2",http://mitadmissions.org/blogs/entry/something_is_coming_part_2_1,1552,0,0,0,0
Mar 13 2010,Chris M. '12,"Decisions, Decisions..",http://mitadmissions.org/blogs/entry/decisions_decisions_2,1552,0,0,0,0
Mar 12 2010,Chris S. '11,Youre Still Our No.1 :),http://mitadmissions.org/blogs/entry/youre_still_our_no1,1553,0,0,0,0
Mar 11 2010,ARTalk,Richard III: Behind-the-scenes,http://mitadmissions.org/blogs/entry/behindthescenes,1554,0,0,0,0
Mar 11 2010,Yan Z. '12,"Unedited notes on gravity, etc.",http://mitadmissions.org/blogs/entry/unedited_notes_on_gravity_etc,1554,0,0,0,0
Mar 10 2010,Hamsika C. '13,Distractions,http://mitadmissions.org/blogs/entry/distractions_1,1555,0,0,0,0
Mar 10 2010,Snively '11,I dont understand,http://mitadmissions.org/blogs/entry/i_dont_understand,1555,0,0,0,0
Mar 9 2010,Jess K. '10,Food Truck Song,http://mitadmissions.org/blogs/entry/food_truck_song,1556,0,0,0,0
Mar 9 2010,Jess K. '10,Throwback,http://mitadmissions.org/blogs/entry/throwback,1556,0,0,0,0
Mar 8 2010,ARTalk,Bright Star,http://mitadmissions.org/blogs/entry/bright_star,1557,0,0,0,0
Mar 7 2010,Kim D. '09,MIT Quidditch: The Best Thing EVER?,http://mitadmissions.org/blogs/entry/mit_quidditch_the_best_thing_ever,1558,9,11,3,23
Mar 6 2010,Jess K. '10,Something is coming..,http://mitadmissions.org/blogs/entry/something_is_coming,1559,1,0,0,1
Mar 5 2010,Hamsika C. '13,"No Pain, No Gain",http://mitadmissions.org/blogs/entry/no_pain_no_gain,1560,0,0,0,0
Mar 4 2010,Celena C. '12,"Before MIT goes APE, I learn how to eat dumplings FAST.",http://mitadmissions.org/blogs/entry/before_mit_goes_ape_i_learn_ho,1561,0,0,0,0
Mar 4 2010,Matt McGann '00,Regular Action Decisions: Sunday 3/14,http://mitadmissions.org/blogs/entry/regular_action_decisions_sunda,1561,0,0,0,0
Mar 3 2010,Keri G. '10,Senior Survey (Says?),http://mitadmissions.org/blogs/entry/senior_survey,1562,0,0,0,0
Mar 2 2010,Matt McGann '00,will.i.am: An entry by Prof. Patrick Henry Winston,http://mitadmissions.org/blogs/entry/william_an_entry_by_prof_patri,1563,0,0,0,0
Mar 2 2010,Matt McGann '00,Quick updates,http://mitadmissions.org/blogs/entry/quick_updates_3,1563,0,0,0,0
Feb 27 2010,Jenny X. '13,MIT goes APE.,http://mitadmissions.org/blogs/entry/mit_goes_ape,1566,0,0,0,0
Feb 26 2010,Chris S. '11,MIT ,http://mitadmissions.org/blogs/entry/mit_3s_you_1,1567,0,0,0,0
Feb 23 2010,Snively '11,BLARGL!,http://mitadmissions.org/blogs/entry/blargl,1570,0,0,0,0
Feb 23 2010,Hamsika C. '13,Just Dance!,http://mitadmissions.org/blogs/entry/just_dance,1570,0,0,0,0
Feb 23 2010,Shannon M. '12,"Well, you just cost me money.",http://mitadmissions.org/blogs/entry/well_you_just_cost_me_money,1570,0,0,0,0
Feb 23 2010,Chris S. '11,"MIT, Time to Step Up?",http://mitadmissions.org/blogs/entry/mit_time_to_step_up,1570,0,0,0,0
Feb 22 2010,ARTalk,MIT has a radio station!?,http://mitadmissions.org/blogs/entry/mit_has_a_radio_station,1571,0,0,0,0
Feb 22 2010,Chris S. '11,Days Without a Laptop,http://mitadmissions.org/blogs/entry/days_without_a_laptop,1571,0,0,0,0
Feb 18 2010,Jenny X. '13,Goodbye Free-Body Diagrams,http://mitadmissions.org/blogs/entry/goodbye_freebody_diagrams,1575,0,0,0,0
Feb 16 2010,Hamsika C. '13,Remember?,http://mitadmissions.org/blogs/entry/remember,1577,0,0,0,0
Feb 16 2010,Financial Aid,Deadline-ish,http://mitadmissions.org/blogs/entry/deadlineish,1577,0,0,0,0
Feb 15 2010,Yan Z. '12,Generally Unrelated to General Relativity,http://mitadmissions.org/blogs/entry/generally_unrelated_to_general,1578,0,0,0,0
Feb 15 2010,ARTalk,How to Stop Traffic and Time,http://mitadmissions.org/blogs/entry/how_to_stop_traffic_and_time,1578,0,1,1,2
Feb 12 2010,Chris M. '12,Livebloggin Ring Premiere!,http://mitadmissions.org/blogs/entry/livebloggin_ring_premiere,1581,0,0,0,0
Feb 12 2010,Snively '11,And we bring you more sketch!,http://mitadmissions.org/blogs/entry/and_we_bring_you_more_sketch,1581,0,0,0,0
Feb 11 2010,Shannon M. '12,T Minus One.,http://mitadmissions.org/blogs/entry/t_minus_one,1582,0,0,0,0
Feb 11 2010,Financial Aid,Financial Aid Applications,http://mitadmissions.org/blogs/entry/financial_aid_applications,1582,1,0,0,1
Feb 10 2010,Kim D. '09,Where do Trees Come From?,http://mitadmissions.org/blogs/entry/where_do_trees_come_from,1583,2,0,0,2
Feb 10 2010,Keri G. '10,FINAL TERM ATTACK,http://mitadmissions.org/blogs/entry/final_term_attack,1583,0,0,0,0
Feb 9 2010,Marcela R. '13,What Ive Been Up To,http://mitadmissions.org/blogs/entry/what_ive_been_up_to,1584,0,0,0,0
Feb 8 2010,Chris S. '11,Doonesbury and MIT,http://mitadmissions.org/blogs/entry/doonesbury_and_mit,1585,36,6,4,46
Feb 8 2010,Chris M. '12,A new semester,http://mitadmissions.org/blogs/entry/a_new_semester,1585,0,0,0,0
Feb 8 2010,ARTalk,Stories from Uganda,http://mitadmissions.org/blogs/entry/stories_from_uganda_1,1585,0,0,0,0
Feb 7 2010,Hamsika C. '13,On Time,http://mitadmissions.org/blogs/entry/on_time,1586,0,0,0,0
Feb 5 2010,ARTalk,..and Here We Go Again!,http://mitadmissions.org/blogs/entry/and_here_we_go_again,1588,0,0,0,0
Feb 4 2010,Snively '11,We bring the sketch to you!,http://mitadmissions.org/blogs/entry/we_bring_the_sketch_to_you,1589,0,0,0,0
Feb 3 2010,Jenny X. '13,To Defeat the Huns,http://mitadmissions.org/blogs/entry/to_defeat_the_huns,1590,0,0,0,0
Feb 2 2010,Matt McGann '00,Time to Complete the MIT Midyear Report,http://mitadmissions.org/blogs/entry/time_to_complete_the_mit_midye,1591,0,3,0,3
Feb 2 2010,Celena C. '12,So What Did I Do During IAP?,http://mitadmissions.org/blogs/entry/so_what_did_i_do_during_iap,1591,0,0,0,0
Feb 2 2010,Yan Z. '12,What I Did on Registration Day,http://mitadmissions.org/blogs/entry/what_i_did_on_registration_day,1591,0,0,0,0
Feb 1 2010,Hamsika C. '13,Lets Get Down to Business,http://mitadmissions.org/blogs/entry/lets_get_down_to_business,1592,0,0,0,0
Feb 1 2010,Cristen C. '10,The Beginning of the End,http://mitadmissions.org/blogs/entry/the_beginning_of_the_end,1592,0,0,0,0
Jan 31 2010,Jenny X. '13,Healthy reflections,http://mitadmissions.org/blogs/entry/healthy_reflections,1593,0,0,0,0
Jan 29 2010,Dave McOwen,Were #1!,http://mitadmissions.org/blogs/entry/were_1,1595,0,0,0,0
Jan 28 2010,Chris S. '11,My Entirely Unexciting IAP,http://mitadmissions.org/blogs/entry/my_entirely_unexciting_iap,1596,0,0,0,0
Jan 26 2010,Hamsika C. '13,Field Trip!,http://mitadmissions.org/blogs/entry/field_trip,1598,0,0,0,0
Jan 25 2010,Matt McGann '00,Regular Action Admissions Update,http://mitadmissions.org/blogs/entry/regular_action_admissions_upda_1,1599,0,0,0,0
Jan 22 2010,Yan Z. '12,"An Asymmetric Discussion of Shoes, the Process of Moving, and 3D Glasses",http://mitadmissions.org/blogs/entry/an_asymmetric_discussion_of_sh,1602,0,0,0,0
Jan 22 2010,Chris M. '12,Sunrise,http://mitadmissions.org/blogs/entry/sunrise,1602,0,0,0,0
Jan 22 2010,Jenny X. '13,Start shaping up in January!,http://mitadmissions.org/blogs/entry/start_shaping_up_in_january,1602,0,0,0,0
Jan 22 2010,Keri G. '10,In or Out?,http://mitadmissions.org/blogs/entry/in_or_out,1602,0,0,0,0
Jan 20 2010,Keri G. '10,A Brief Addition to My Last Exposition,http://mitadmissions.org/blogs/entry/a_brief_addition_to_my_last_ex,1604,0,0,0,0
Jan 18 2010,Keri G. '10,"Life, or Why Im Afraid Of It",http://mitadmissions.org/blogs/entry/life_or_why_im_afraid_of_it,1606,0,0,0,0
Jan 18 2010,Hamsika C. '13,Building 46,http://mitadmissions.org/blogs/entry/building_46,1606,0,0,0,0
Jan 16 2010,Kim Hunter '86,Its a puzzlement,http://mitadmissions.org/blogs/entry/its_a_puzzlement_1,1608,0,0,0,0
Jan 15 2010,Shannon M. '12,Why Im Baking Cookies Tonight.,http://mitadmissions.org/blogs/entry/another_tobetitled_iap_entry,1609,0,0,0,0
Jan 14 2010,Matt McGann '00,About the Midyear Report,http://mitadmissions.org/blogs/entry/about_the_midyear_report,1610,0,0,0,0
Jan 14 2010,Matt McGann '00,For EA Deferred Students,http://mitadmissions.org/blogs/entry/for_ea_deferred_students,1610,0,0,0,0
Jan 13 2010,Cam T. '13,Two Blogs,http://mitadmissions.org/blogs/entry/two_blogs,1611,0,0,0,0
Jan 12 2010,Snively '11,Watch our robot grow up!,http://mitadmissions.org/blogs/entry/watch_our_robot_grow_up,1612,0,0,0,0
Jan 12 2010,Hamsika C. '13,Just My Luck,http://mitadmissions.org/blogs/entry/ambulance_tales,1612,0,0,0,0
Jan 12 2010,Chris Peterson,Kickoff!,http://mitadmissions.org/blogs/entry/kickoff,1612,0,0,0,0
Jan 9 2010,Hamsika C. '13,I Can Save You,http://mitadmissions.org/blogs/entry/i_can_save_you,1615,0,0,0,0
Jan 9 2010,Dave McOwen,the Colbert Bump,http://mitadmissions.org/blogs/entry/the_colbert_bump,1615,0,0,0,0
Jan 8 2010,Celena C. '12,Quick update from SB,http://mitadmissions.org/blogs/entry/quick_update_from_sb_1,1616,0,0,0,0
Jan 6 2010,Jess K. '10,Rambax MIT,http://mitadmissions.org/blogs/entry/rambax_mit,1618,0,0,0,0
Jan 3 2010,Hamsika C. '13,Back,http://mitadmissions.org/blogs/entry/back,1621,0,0,0,0
Jan 1 2010,Jenny X. '13,Movin On,http://mitadmissions.org/blogs/entry/movin_on,1623,0,0,0,0
Jan 1 2010,Cam T. '13,Passions,http://mitadmissions.org/blogs/entry/passion,1623,0,0,0,0
Jan 1 2010,Yan Z. '12,Guest Blog: Music and Mayhem by Jess 12,http://mitadmissions.org/blogs/entry/guest_blog_music_and_mayhem_by,1623,0,0,0,0
Dec 29 2009,Matt McGann '00,MIT Regular Action Deadline,http://mitadmissions.org/blogs/entry/mit_regular_action_deadline_1,1626,0,0,0,0
Dec 28 2009,Chris S. '11,MIT Undergraduates by Major,http://mitadmissions.org/blogs/entry/mit_undergraduates_by_major,1627,0,4,0,4
Dec 27 2009,Yan Z. '12,Winter Miscellania,http://mitadmissions.org/blogs/entry/winter_miscellania,1628,0,0,0,0
Dec 26 2009,Cam T. '13,Construction,http://mitadmissions.org/blogs/entry/construction,1629,0,0,0,0
Dec 24 2009,Jenny X. '13,10 Things I Learned 1st Semester,http://mitadmissions.org/blogs/entry/10_things_i_learned_1st_semest,1631,0,1,0,1
Dec 23 2009,Chris S. '11,"Show, Dont Tell! (the College Essay, Pt. 2)",http://mitadmissions.org/blogs/entry/show_dont_tell_the_college_ess,1632,14,10,1,25
Dec 21 2009,Chris Peterson,Snow,http://mitadmissions.org/blogs/entry/snow,1634,0,0,0,0
Dec 20 2009,Yan Z. '12,Snacks on a Plane,http://mitadmissions.org/blogs/entry/snacks_on_a_plane,1635,0,0,0,0
Dec 17 2009,Jenny X. '13,Aftermath,http://mitadmissions.org/blogs/entry/aftermath,1638,0,0,0,0
Dec 16 2009,Decisions,EA Decisions,http://mitadmissions.org/blogs/entry/ea_decisions,1639,0,0,0,0
Dec 16 2009,Decisions,Admitted,http://mitadmissions.org/blogs/entry/admitted_6,1639,0,0,0,0
Dec 16 2009,Decisions,Deferred,http://mitadmissions.org/blogs/entry/deferred_4,1639,0,0,0,0
Dec 16 2009,Decisions,Not Admitted,http://mitadmissions.org/blogs/entry/not_admitted_5,1639,0,0,0,0
Dec 16 2009,Cam T. '13,Facebook.,http://mitadmissions.org/blogs/entry/facebook,1639,0,0,0,0
Dec 16 2009,Hamsika C. '13,To the Deferred,http://mitadmissions.org/blogs/entry/to_the_deferred,1639,1,0,0,1
Dec 16 2009,Celena C. '12,GOOD LUCK,http://mitadmissions.org/blogs/entry/good_luck,1639,7,1,3,11
Dec 16 2009,Dave McOwen,Science is Delicious!,http://mitadmissions.org/blogs/entry/science_is_delicious,1639,1,0,0,1
Dec 15 2009,Chris S. '11,40 Hours Left!,http://mitadmissions.org/blogs/entry/40_hours_left,1640,0,0,0,0
Dec 15 2009,Matt McGann '00,Finals Week,http://mitadmissions.org/blogs/entry/finals_week,1640,0,0,0,0
Dec 11 2009,Matt McGann '00,Early Action Decisions: Wednesday 12/16,http://mitadmissions.org/blogs/entry/early_action_decisions_wednesd,1644,0,0,0,0
Dec 10 2009,Hamsika C. '13,Its Legit,http://mitadmissions.org/blogs/entry/its_legit,1645,0,0,0,0
Dec 9 2009,Snively '11,Stand Back!,http://mitadmissions.org/blogs/entry/stand_back,1646,0,0,0,0
Dec 7 2009,Yan Z. '12,8 Hypotheses,http://mitadmissions.org/blogs/entry/8_hypotheses,1648,0,0,0,0
Dec 6 2009,Chris S. '11,Ode to a Package of Dial Soap,http://mitadmissions.org/blogs/entry/ode_to_a_package_of_dial_soap,1649,0,0,0,0
Dec 5 2009,Snively '11,WE FOUND ALL THE BALLOONS!!!,http://mitadmissions.org/blogs/entry/we_found_all_the_balloons,1650,0,0,0,0
Dec 4 2009,Hamsika C. '13,Padma Lakshmi at MIT,http://mitadmissions.org/blogs/entry/padma_lakshmi_at_mit,1651,0,0,0,0
Dec 4 2009,Snively '11,10 Red Balloons,http://mitadmissions.org/blogs/entry/10_red_balloons,1651,0,0,0,0
Dec 3 2009,Snively '11,I have the best girlfriend ever,http://mitadmissions.org/blogs/entry/i_have_the_best_girlfriend_eve,1652,0,0,0,0
Dec 1 2009,Hamsika C. '13,"Nice Try, Caltech",http://mitadmissions.org/blogs/entry/nice_try_caltech_1,1654,0,1,0,1
Nov 29 2009,Jess K. '10,Traditions,http://mitadmissions.org/blogs/entry/traditions,1656,0,0,0,0
Nov 25 2009,Paul B. '11,Vote for Ksplice!,http://mitadmissions.org/blogs/entry/vote_for_ksplice,1660,0,0,0,0
Nov 25 2009,Kim D. '09,MIT Womens Soccer,http://mitadmissions.org/blogs/entry/mit_womens_soccer,1660,0,0,0,0
Nov 24 2009,Hamsika C. '13,Top Ten Reasons Im Thankful for Thanksgiving,http://mitadmissions.org/blogs/entry/top_ten_reasons_im_thankful_fo,1661,4,3,0,7
Nov 23 2009,Jess K. '10,"An Evening With BJ Novak, opened by Barack Obama",http://mitadmissions.org/blogs/entry/an_evening_with_bj_novak_opene_1,1662,0,0,0,0
Nov 22 2009,Matt McGann '00,Three MIT students win Rhodes Scholarships,http://mitadmissions.org/blogs/entry/three_mit_students_win_rhodes,1663,0,0,0,0
Nov 22 2009,Kim D. '09,Dont Read This if you Already Go to MIT,http://mitadmissions.org/blogs/entry/dont_read_this_if_you_already,1663,0,0,0,0
Nov 21 2009,Jenny X. '13,Potpourri Blog Post,http://mitadmissions.org/blogs/entry/potpourri_blog_post,1664,0,0,0,0
Nov 18 2009,Matt McGann '00,EA Update: App Tracking & More,http://mitadmissions.org/blogs/entry/ea_update_app_tracking_more,1667,0,0,0,0
Nov 18 2009,Snively '11,A short entry,http://mitadmissions.org/blogs/entry/a_short_entry,1667,0,0,0,0
Nov 18 2009,Yan Z. '12,Relativity Special (and vice versa),http://mitadmissions.org/blogs/entry/relativity_special_and_vice_ve,1667,0,0,0,0
Nov 15 2009,Hamsika C. '13,Tunnel Adventures,http://mitadmissions.org/blogs/entry/tunnel,1670,0,0,0,0
Nov 15 2009,Cam T. '13,Blogger Freebie #2,http://mitadmissions.org/blogs/entry/blogger_freebie_2,1670,0,0,0,0
Nov 15 2009,Chris S. '11,Another Type of Mens et MANUS,http://mitadmissions.org/blogs/entry/another_type_of_mens_et_manus,1670,0,0,0,0
Nov 15 2009,Celena C. '12,TGIF!,http://mitadmissions.org/blogs/entry/tgif,1670,0,0,0,0
Nov 11 2009,Marcela R. '13,"Balancing Life, School, and More Life?",http://mitadmissions.org/blogs/entry/balancing_life_school_and_more_1,1674,0,0,0,0
Nov 11 2009,Yan Z. '12,More thoughts on classes,http://mitadmissions.org/blogs/entry/more_thoughts_on_classes,1674,0,0,0,0
Nov 10 2009,Matt McGann '00,Wheres My Stuff?,http://mitadmissions.org/blogs/entry/wheres_my_stuff_1,1675,0,0,0,0
Nov 8 2009,Chris M. '12,You know what would be cool?,http://mitadmissions.org/blogs/entry/you_know_what_would_be_cool,1677,2,1,4,7
Nov 8 2009,Matt McGann '00,Always Moving Forward: An entry by Prof. Patrick Henry Winston,http://mitadmissions.org/blogs/entry/always_moving_forward_an_entry,1677,0,0,0,0
Nov 5 2009,Hamsika C. '13,Sights and Sounds,http://mitadmissions.org/blogs/entry/lols,1680,0,0,0,0
Nov 4 2009,ROTC,"AFROTC = stress, and why thats okay",http://mitadmissions.org/blogs/entry/afrotc_stress_and_why_thats_ok,1681,0,0,0,0
Nov 4 2009,Chris M. '12,Train(wreck) of Thought,http://mitadmissions.org/blogs/entry/trainwreck_of_thought,1681,0,0,0,0
Nov 4 2009,Yan Z. '12,tEpikazoo,http://mitadmissions.org/blogs/entry/tepikazoo,1681,0,0,0,0
Nov 2 2009,Hamsika C. '13,So How Does It Feel?,http://mitadmissions.org/blogs/entry/so_how_does_it_feel,1683,0,0,0,0
Oct 31 2009,Chris S. '11,OCTOBERRR,http://mitadmissions.org/blogs/entry/octoberrr,1685,0,0,0,0
Oct 31 2009,Kim D. '09,Shiny Circuits,http://mitadmissions.org/blogs/entry/shiny_circuits,1685,3,1,1,5
Oct 31 2009,Matt McGann '00,EA Deadline: Your Questions [Updated],http://mitadmissions.org/blogs/entry/ea_deadline_your_questions_upd,1685,0,0,0,0
Oct 30 2009,Dave McOwen,Dont Panic!,http://mitadmissions.org/blogs/entry/dont_panic,1686,0,0,0,0
Oct 29 2009,Jenny X. '13,Mens et Manus - mainly Manus!,http://mitadmissions.org/blogs/entry/mens_et_manus_mainly_manus,1687,0,0,0,0
Oct 28 2009,Paul B. '11,Pick My Halloween Costume!,http://mitadmissions.org/blogs/entry/pick_my_halloween_costume,1688,0,0,0,0
Oct 28 2009,Shannon M. '12,How to look over your application and advice about breathing.,http://mitadmissions.org/blogs/entry/how_to_look_over_your_applicat,1688,3,1,0,4
Oct 28 2009,Snively '11,Alaska,http://mitadmissions.org/blogs/entry/alaska,1688,0,0,0,0
Oct 28 2009,Marcela R. '13,On a Week of IHTFP,http://mitadmissions.org/blogs/entry/on_a_week_of_ihtfp,1688,0,0,0,0
Oct 26 2009,Yan Z. '12,I had a terrible week,http://mitadmissions.org/blogs/entry/i_had_a_terrible_week,1690,0,0,0,0
Oct 25 2009,Snively '11,If the Obama were a unit of measure . . .,http://mitadmissions.org/blogs/entry/if_the_obama_were_a_unit_of_me,1691,0,4,0,4
Oct 23 2009,Hamsika C. '13,Snow-bama,http://mitadmissions.org/blogs/entry/snowbama_1,1693,0,0,0,0
Oct 23 2009,Keri G. '10,Thoughts on Removing the Long Essay from the Freshman Application,http://mitadmissions.org/blogs/entry/thoughts_on_removing_the_long,1693,0,0,0,0
Oct 23 2009,Matt McGann '00,"Obama to speak on clean energy, visit MIT energy labs today",http://mitadmissions.org/blogs/entry/obama_to_speak_on_clean_energy,1693,0,0,0,0
Oct 21 2009,Cam T. '13,Roman Life,http://mitadmissions.org/blogs/entry/roman_life,1695,0,0,0,0
Oct 20 2009,Mikey Yang '05,Obamas Visiting MIT!,http://mitadmissions.org/blogs/entry/obamas_visiting_mit,1696,0,0,0,0
Oct 18 2009,Quinton McArthur,Paper Planes,http://mitadmissions.org/blogs/entry/paper_planes_1,1698,0,0,0,0
Oct 15 2009,Celena C. '12,MIT is Utopia,http://mitadmissions.org/blogs/entry/mit_is_utopia_1,1701,0,0,0,0
Oct 14 2009,Hamsika C. '13,Come Visit!,http://mitadmissions.org/blogs/entry/come_visit_1,1702,0,0,0,0
Oct 14 2009,Chris Peterson,Going Social,http://mitadmissions.org/blogs/entry/going_social,1702,0,0,0,0
Oct 12 2009,Snively '11,Liveblog: Info Session with Karyn Blaser!,http://mitadmissions.org/blogs/entry/liveblog_info_session_with_kar,1704,1,0,0,1
Oct 10 2009,Quinton McArthur,Advice for Seniors,http://mitadmissions.org/blogs/entry/advice_for_seniors_1,1706,0,0,0,0
Oct 10 2009,Jenny X. '13,LETS PLAY,http://mitadmissions.org/blogs/entry/lets_play,1706,0,0,0,0
Oct 10 2009,Snively '11,Mind and Hand,http://mitadmissions.org/blogs/entry/mind_and_hand_1,1706,0,0,0,0
Oct 8 2009,Cam T. '13,Blogural Inaugural,http://mitadmissions.org/blogs/entry/blogural_inaugural,1708,4,1,3,8
Oct 8 2009,Kim D. '09,Do you have jobs?,http://mitadmissions.org/blogs/entry/do_you_have_jobs,1708,0,0,0,0
Oct 8 2009,Dave McOwen,MIT Admission Interview,http://mitadmissions.org/blogs/entry/mit_admissions_interview,1708,0,0,0,0
Oct 7 2009,Hamsika C. '13,Work and Energy,http://mitadmissions.org/blogs/entry/work_and_energy,1709,0,0,0,0
Oct 6 2009,Dave McOwen,I dont like SPAM!,http://mitadmissions.org/blogs/entry/i_dont_like_spam,1710,0,0,0,0
Oct 5 2009,Cristen C. '10,Welcome to the Woodshop,http://mitadmissions.org/blogs/entry/welcome_to_the_woodshop,1711,0,0,0,0
Oct 4 2009,Celena C. '12,Welcome to my home,http://mitadmissions.org/blogs/entry/welcome_to_my_home,1712,0,0,0,0
Oct 3 2009,Jess K. '10,Brief Wondrous Lives,http://mitadmissions.org/blogs/entry/brief_wondrous_lives,1713,0,0,0,0
Oct 3 2009,Marcela R. '13,TLM,http://mitadmissions.org/blogs/entry/tlm,1713,0,0,0,0
Oct 2 2009,Jenny X. '13,LIFE!,http://mitadmissions.org/blogs/entry/life,1714,1,1,1,3
Oct 2 2009,Keri G. '10,In which brains are awesome,http://mitadmissions.org/blogs/entry/in_which_brains_are_awesome_1,1714,0,0,0,0
Oct 2 2009,Snively '11,Turn around and pretend it wasnt you,http://mitadmissions.org/blogs/entry/turn_around_and_pretend_it_was,1714,0,0,0,0
Oct 2 2009,Mitra L. '07,"Past, Present, and Future",http://mitadmissions.org/blogs/entry/past_present_and_future_1,1714,0,0,0,0
Oct 2 2009,Hamsika C. '13,Start of Something New,http://mitadmissions.org/blogs/entry/start_of_something_new,1714,1,0,0,1
Oct 2 2009,Chris S. '11,SEPTEMBERRR,http://mitadmissions.org/blogs/entry/septemberrr,1714,0,0,0,0
Oct 1 2009,Matt McGann '00,MIT Blogs Featured in NY Times,http://mitadmissions.org/blogs/entry/mit_blogs_featured_in_ny_times,1715,0,0,0,0
Oct 1 2009,Kim D. '09,Three Things That Are Awesome,http://mitadmissions.org/blogs/entry/three_things_that_are_awesome_1,1715,0,0,0,0
Oct 1 2009,Yan Z. '12,Physics in the MIT,http://mitadmissions.org/blogs/entry/physics_in_the_mit_1,1715,0,0,0,0
Sep 30 2009,Chris M. '12,Birthday! (a.k.a my first video blog),http://mitadmissions.org/blogs/entry/birthday_aka_my_first_video_bl_1,1716,0,0,0,0
Sep 28 2009,Laura N. '09,"Product Design, MIT style",http://mitadmissions.org/blogs/entry/why_2009_is_fun,1718,0,1,0,1
Sep 25 2009,Keri G. '10,ADITL,http://mitadmissions.org/blogs/entry/aditl_1,1721,0,0,0,0
Sep 25 2009,Snively '11,Party in the MIT,http://mitadmissions.org/blogs/entry/party_in_the_mit,1721,1,0,0,1
Sep 24 2009,Matt McGann '00,Some recommendations about recommendations,http://mitadmissions.org/blogs/entry/some_recommendations_about_rec,1722,0,0,0,0
Sep 23 2009,Snively '11,*Oink Oink*,http://mitadmissions.org/blogs/entry/oink_oink,1723,0,0,0,0
Sep 22 2009,ARTalk,Truth Values,http://mitadmissions.org/blogs/entry/truth_values,1724,0,0,0,0
Sep 21 2009,Yan Z. '12,Blog Entry: Recession Edition,http://mitadmissions.org/blogs/entry/blog_entry_recession_edition,1725,0,0,0,0
Sep 19 2009,Snively '11,Intense Procrastination,http://mitadmissions.org/blogs/entry/intense_procrastination,1727,0,0,0,0
Sep 17 2009,Snively '11,My Schedule!,http://mitadmissions.org/blogs/entry/my_schedule_1,1729,0,0,0,0
Sep 13 2009,Yan Z. '12,Week 1,http://mitadmissions.org/blogs/entry/week_1,1733,0,0,0,0
Sep 10 2009,Chris M. '12,What its like being back,http://mitadmissions.org/blogs/entry/what_im_doing,1736,0,0,0,0
Sep 10 2009,Chris S. '11,Second Day of Class,http://mitadmissions.org/blogs/entry/second_day_of_class,1736,0,0,0,0
Sep 10 2009,Snively '11,Phew!,http://mitadmissions.org/blogs/entry/phew,1736,0,0,0,0
Sep 8 2009,Bryan O. '09,WhoaYoure Old,http://mitadmissions.org/blogs/entry/post_22,1738,0,0,0,0
Sep 8 2009,Matt McGann '00,Application question: scholastic and non-scholastic distinctions?,http://mitadmissions.org/blogs/entry/application_question_scholasti,1738,1,10,0,11
Sep 7 2009,Yan Z. '12,Schedilemmas,http://mitadmissions.org/blogs/entry/schedilemmas,1739,0,0,0,0
Sep 6 2009,Lulu L. '09,Disappearing (or life goes on),http://mitadmissions.org/blogs/entry/disappearing_or_life_goes_on,1740,0,0,0,0
Aug 31 2009,Chris Peterson,Hello world.,http://mitadmissions.org/blogs/entry/hello_world_2,1746,0,0,0,0
Aug 31 2009,Matt McGann '00,"Introducing the Class of 2013: Merritt 13, Carlos 13, Edward 13, and John 13",http://mitadmissions.org/blogs/entry/introducing_the_class_of_2013_8,1746,0,0,0,0
Aug 30 2009,Yan Z. '12,Ruminations and room-inations,http://mitadmissions.org/blogs/entry/ruminations_and_roominations,1747,0,0,0,0
Aug 28 2009,Cristen C. '10,A Characterization,http://mitadmissions.org/blogs/entry/cristen_the_character,1749,0,0,0,0
Aug 28 2009,Laura N. '09,Commencement 2009,http://mitadmissions.org/blogs/entry/commencement_2009,1749,0,0,0,0
Aug 27 2009,Dave McOwen,And the winners are,http://mitadmissions.org/blogs/entry/and_the_winners_are,1750,0,0,0,0
Aug 26 2009,Quinton McArthur,Operabots with Personality,http://mitadmissions.org/blogs/entry/operabots_with_personality,1751,0,1,0,1
Aug 26 2009,Matt McGann '00,"Introducing the Class of 2013: Scott 13, Cory 13, Edner 13, Jeremy 13, and Bee 13",http://mitadmissions.org/blogs/entry/introducing_the_class_of_2013_7,1751,0,0,0,0
Aug 25 2009,Paul B. '11,What Am I Forgetting?,http://mitadmissions.org/blogs/entry/what_am_i_forgetting,1752,0,0,0,0
Aug 23 2009,Yan Z. '12,A Short Dining Guide to Cambridge,http://mitadmissions.org/blogs/entry/a_short_dining_guide_to_cambri,1754,0,0,0,0
Aug 23 2009,Chris S. '11,"San Francisco, je taime",http://mitadmissions.org/blogs/entry/sf_je_taime,1754,0,0,0,0
Aug 20 2009,Snively '11,A World Record Attempt,http://mitadmissions.org/blogs/entry/a_world_record_attempt,1757,0,0,0,0
Aug 20 2009,Mikey Yang '05,To RFID or not to RFID?,http://mitadmissions.org/blogs/entry/to_rfid_or_not_to_rfid,1757,0,0,0,0
Aug 20 2009,Matt McGann '00,"Introducing the Class of 2013: Henrique 13, Chika 13, and Qinxuan 13",http://mitadmissions.org/blogs/entry/introducing_the_class_of_2013_6,1757,0,0,0,0
Aug 19 2009,Kim Hunter '86,"Yes,The New AppIts Really Here",http://mitadmissions.org/blogs/entry/yesthe_new_appits_really_here_1,1758,0,0,0,0
Aug 18 2009,Chris S. '11,On Flying,http://mitadmissions.org/blogs/entry/on_flying,1759,0,0,0,0
Aug 17 2009,Yan Z. '12,Meteor Shower,http://mitadmissions.org/blogs/entry/meteor_shower,1760,0,0,0,0
Aug 13 2009,Dave McOwen,Ben 2.0,http://mitadmissions.org/blogs/entry/ben_20,1764,0,0,0,0
Aug 11 2009,Keri G. '10,In which I am no longer new here,http://mitadmissions.org/blogs/entry/in_which_i_am_no_longer_new_he,1766,0,0,0,0
Aug 10 2009,Matt McGann '00,Introducing the Class of 2013: Trevor 13,http://mitadmissions.org/blogs/entry/introducing_the_class_of_2013_5,1767,0,0,0,0
Aug 8 2009,Yan Z. '12,"An Unofficial Guide to Unstandard MITglish, 1st Edition",http://mitadmissions.org/blogs/entry/an_unofficial_guide_to_unoffic,1769,18,8,15,41
Aug 7 2009,Ahmed H. '12,The Hawk Flies High,http://mitadmissions.org/blogs/entry/the_hawk_flies_high_1,1770,0,0,0,0
Aug 7 2009,Matt McGann '00,Introducing the Class of 2013: Twins Chandler 13 and Taylor 13,http://mitadmissions.org/blogs/entry/introducing_the_class_of_2013_4,1770,0,1,0,1
Aug 6 2009,Jess K. '10,Fuji: Not Your Grandmas Mountain,http://mitadmissions.org/blogs/entry/fuji_not_your_grandmas_mountai,1771,0,0,0,0
Aug 4 2009,Dave McOwen,2009: Let There Be Bloggers!,http://mitadmissions.org/blogs/entry/2009_let_there_be_bloggers,1773,0,0,0,0
Aug 4 2009,Chris S. '11,The Challenge of Public Health,http://mitadmissions.org/blogs/entry/the_challenge_of_public_health,1773,0,0,0,0
Aug 2 2009,Snively '11,Cheat Sheet,http://mitadmissions.org/blogs/entry/cheat_sheet,1775,0,0,0,0
Jul 31 2009,Cristen C. '10,You should live in EAsT camPUS,http://mitadmissions.org/blogs/entry/you_should_live_in_east_campus,1777,0,0,0,0
Jul 30 2009,Yan Z. '12,A Heartbreaking Lunch of Staggering Genius,http://mitadmissions.org/blogs/entry/a_heartbreaking_lunch_of_stagg,1778,0,0,0,0
Jul 30 2009,Snively '11,You should live in Burton-Conner!,http://mitadmissions.org/blogs/entry/you_should_live_in_burtonconne,1778,0,0,0,0
Jul 30 2009,Matt McGann '00,Introducing the Class of 2013: Jonte 13,http://mitadmissions.org/blogs/entry/introducing_the_class_of_2013_3,1778,0,0,0,0
Jul 29 2009,Chris M. '12,What do Alums do?,http://mitadmissions.org/blogs/entry/what_do_alums_do,1779,0,0,0,0
Jul 28 2009,Snively '11,Livescribes Pulse Pen: The Sequel!,http://mitadmissions.org/blogs/entry/livescribes_pulse_pen_the_sequ,1780,0,0,0,0
Jul 28 2009,Ahmed H. '12,Summertime,http://mitadmissions.org/blogs/entry/summertime_2,1780,0,0,0,0
Jul 27 2009,Matt McGann '00,Introducing the Class of 2013: Sean 13,http://mitadmissions.org/blogs/entry/introducing_the_class_of_2013_2,1781,0,0,0,0
Jul 24 2009,Keri G. '10,Mattress Dominoes!,http://mitadmissions.org/blogs/entry/mattress_dominoes_1,1784,0,0,0,0
Jul 24 2009,Chris S. '11,What YOURE Doing This Summer!,http://mitadmissions.org/blogs/entry/what_youre_doing_this_summer,1784,0,0,0,0
Jul 22 2009,Chris M. '12,Money! Money! Money!,http://mitadmissions.org/blogs/entry/money_money_money,1786,0,0,0,0
Jul 22 2009,Matt McGann '00,Introducing the Class of 2013: Terence 13,http://mitadmissions.org/blogs/entry/introducing_the_class_of_2013_1,1786,0,0,0,0
Jul 21 2009,Yan Z. '12,Six Recent Life-Changing Thoughts on Food,http://mitadmissions.org/blogs/entry/six_thoughts_on_food,1787,0,0,0,0
Jul 20 2009,Matt McGann '00,Celebrating the Moon Landing,http://mitadmissions.org/blogs/entry/celebrating_the_moon_landing,1788,1,0,0,1
Jul 19 2009,Snively '11,A Story,http://mitadmissions.org/blogs/entry/a_story,1789,0,0,0,0
Jul 17 2009,Matt McGann '00,Introducing the Class of 2013: Christy 13,http://mitadmissions.org/blogs/entry/introducing_the_class_of_2013,1791,0,0,0,0
Jul 16 2009,Snively '11,Keep in mind,http://mitadmissions.org/blogs/entry/keep_in_mind,1792,0,0,0,0
Jul 15 2009,Chris M. '12,What have you been doing lately?,http://mitadmissions.org/blogs/entry/what_have_you_been_doing_latel,1793,0,0,0,0
Jul 14 2009,Yan Z. '12,"Oh, the Places Youll Go(ogle)",http://mitadmissions.org/blogs/entry/oh_the_places_youll_google,1794,0,0,0,0
Jul 14 2009,Snively '11,Stay Tuned,http://mitadmissions.org/blogs/entry/stay_tuned,1794,0,0,0,0
Jul 8 2009,Jess K. '10,iDoor,http://mitadmissions.org/blogs/entry/idoor_1,1800,0,2,0,2
Jul 7 2009,Yan Z. '12,A Supposedly Fun Thing That Ill Probably Do Again,http://mitadmissions.org/blogs/entry/a_supposedly_fun_thing_that_il,1801,0,0,0,0
Jul 4 2009,Chris S. '11,What Are YOU Up To This Summer?,http://mitadmissions.org/blogs/entry/what_are_you_up_to_this_summer,1804,0,0,0,0
Jul 3 2009,Jess K. '10,Seven Years of Good Luck,http://mitadmissions.org/blogs/entry/seven_years_of_good_luck,1805,1,0,0,1
Jul 2 2009,Snively '11,Hits from the 90s,http://mitadmissions.org/blogs/entry/hits_from_the_90s,1806,0,0,0,0
Jul 2 2009,Yan Z. '12,Alternative Transportation,http://mitadmissions.org/blogs/entry/alternative_transportation,1806,0,0,0,0
Jun 29 2009,Snively '11,Vroom Vroom!,http://mitadmissions.org/blogs/entry/vroom_vroom,1809,0,1,0,1
Jun 29 2009,Jess K. '10,10:31,http://mitadmissions.org/blogs/entry/one_1031,1809,0,0,0,0
Jun 28 2009,Chris S. '11,I Climbed a Mountain Today,http://mitadmissions.org/blogs/entry/i_climbed_a_mountain_today,1810,0,0,0,0
Jun 28 2009,Yan Z. '12,Snapshot #1,http://mitadmissions.org/blogs/entry/snapshot_1,1810,0,0,0,0
Jun 27 2009,Chris M. '12,Results from the Photo Scavenger Hunt,http://mitadmissions.org/blogs/entry/results_from_the_photo_scaveng_1,1811,0,0,0,0
Jun 24 2009,Snively '11,Dorms,http://mitadmissions.org/blogs/entry/dorms,1814,0,0,0,0
Jun 23 2009,Keri G. '10,"Hello, Layover (Part Two)",http://mitadmissions.org/blogs/entry/hello_layover_part_two,1815,0,0,0,0
Jun 22 2009,Mikey Yang '05,"Diabolo, Pandora, and Bad TV Shows",http://mitadmissions.org/blogs/entry/diabolo_pandora_and_bad_tv_sho,1816,0,0,0,0
Jun 21 2009,Snively '11,Know when to hold em,http://mitadmissions.org/blogs/entry/know_when_to_hold_em,1817,0,0,0,0
Jun 20 2009,Quinton McArthur,Campos on Campus,http://mitadmissions.org/blogs/entry/campos_on_campus,1818,0,0,0,0
Jun 20 2009,Yan Z. '12,MITiplication,http://mitadmissions.org/blogs/entry/mitiplication,1818,0,0,0,0
Jun 19 2009,Chris M. '12,MITwitter,http://mitadmissions.org/blogs/entry/mitwitter,1819,0,0,0,0
Jun 15 2009,Chris M. '12,Photo Scavenger Hunt,http://mitadmissions.org/blogs/entry/photo_scavenger_hunt,1823,0,0,0,0
Jun 14 2009,Yan Z. '12,"Campus visit, revisited",http://mitadmissions.org/blogs/entry/campus_visit_revisited,1824,0,0,0,0
Jun 12 2009,Jess K. '10,Lost and Found,http://mitadmissions.org/blogs/entry/lost_and_found,1826,0,0,0,0
Jun 11 2009,Keri G. '10,In which I show no restraint whatsoever,http://mitadmissions.org/blogs/entry/in_which_i_show_no_restraint_w,1827,0,0,0,0
Jun 7 2009,Kim D. '09,I put on my robe and graduation hat,http://mitadmissions.org/blogs/entry/i_put_on_my_robe_and_graduatio,1831,0,0,0,0
Jun 5 2009,Yan Z. '12,Comments-ment Webcast,http://mitadmissions.org/blogs/entry/recap,1833,0,0,0,0
Jun 5 2009,Laura N. '09,Commencement Webcast,http://mitadmissions.org/blogs/entry/commencement_webcast,1833,0,0,0,0
Jun 1 2009,Jess K. '10,The Grandest of Road Trips,http://mitadmissions.org/blogs/entry/post_21,1837,0,0,0,0
May 28 2009,Laura N. '09,What happened since the end.,http://mitadmissions.org/blogs/entry/what_happened_since_the_end,1841,0,0,0,0
May 27 2009,Lulu L. '09,"Where are you going, where have you been? (Part I)",http://mitadmissions.org/blogs/entry/where_are_you_going_where_have_2,1842,0,0,0,0
May 26 2009,Daniel Barkowitz,Moneymans Top 10 - a Greatest Hits,http://mitadmissions.org/blogs/entry/moneymans_top_10_a_greatest_hi,1843,0,0,0,0
May 25 2009,Yan Z. '12,Outside the box,http://mitadmissions.org/blogs/entry/post_20,1844,0,0,0,0
May 25 2009,Lulu L. '09,Laptop,http://mitadmissions.org/blogs/entry/laptop,1844,0,0,0,0
May 24 2009,Snively '11,Back Home,http://mitadmissions.org/blogs/entry/back_home,1845,0,0,0,0
May 24 2009,Lulu L. '09,"Where are you going, where have you been?",http://mitadmissions.org/blogs/entry/where_are_you_going_where_have_1,1845,0,0,0,0
May 23 2009,Chris S. '11,Going Home,http://mitadmissions.org/blogs/entry/going_home,1846,0,0,0,0
May 22 2009,Snively '11,Removing a hack,http://mitadmissions.org/blogs/entry/removing_a_hack,1847,0,0,0,0
May 21 2009,Yan Z. '12,Epilogue,http://mitadmissions.org/blogs/entry/epilogue,1848,0,0,0,0
May 20 2009,Paul B. '11,"Athena, Deliver Us From Finals",http://mitadmissions.org/blogs/entry/athena_deliver_us_from_finals,1849,0,0,0,0
May 19 2009,Snively '11,*waves goodbye*,http://mitadmissions.org/blogs/entry/waves_goodbye,1850,0,0,0,0
May 18 2009,Kim Hunter '86,Finals WeekA Different View,http://mitadmissions.org/blogs/entry/finals_weeka_different_view_1,1851,0,0,0,0
May 17 2009,Cristen C. '10,Past Enrollment On A Map,http://mitadmissions.org/blogs/entry/past_enrollment_on_a_map,1852,0,0,0,0
May 17 2009,Shannon M. '12,"And now, for a brief interlude from our regularly scheduled finals whining.",http://mitadmissions.org/blogs/entry/and_now_for_a_brief_interlude,1852,0,0,0,0
May 17 2009,Snively '11,One Giant Leap,http://mitadmissions.org/blogs/entry/one_giant_leap,1852,0,0,0,0
May 17 2009,Chris S. '11,Procrastination For Finals 2,http://mitadmissions.org/blogs/entry/procrastination_for_finals_2,1852,0,0,0,0
May 16 2009,Chris M. '12,My first real internship,http://mitadmissions.org/blogs/entry/my_first_real_internship_1,1853,0,0,0,0
May 15 2009,Snively '11,Wolfram Alpha Tonight!,http://mitadmissions.org/blogs/entry/wolfram_alpha_tonight,1854,0,0,0,0
May 15 2009,Lulu L. '09,Still Going,http://mitadmissions.org/blogs/entry/still_going,1854,0,0,0,0
May 14 2009,Laura N. '09,The End.,http://mitadmissions.org/blogs/entry/the_end,1855,0,0,0,0
May 14 2009,Snively '11,Being First is Important,http://mitadmissions.org/blogs/entry/being_first_is_important,1855,0,0,0,0
May 13 2009,Chris S. '11,Procrastination For Finals,http://mitadmissions.org/blogs/entry/procrastination_for_finals,1856,0,0,0,0
May 13 2009,Matt McGann '00,"The Waitlist, 2009",http://mitadmissions.org/blogs/entry/the_waitlist_2009,1856,0,0,0,0
May 12 2009,ARTalk,Exhibitions@MIT,http://mitadmissions.org/blogs/entry/exhibitionsmit,1857,0,0,0,0
May 12 2009,Daniel Barkowitz,Calculating your Financial Aid,http://mitadmissions.org/blogs/entry/calculating_your_financial_aid_1,1857,0,0,0,0
May 11 2009,Laura N. '09,"Really, I dont feel like thinking of a title right now",http://mitadmissions.org/blogs/entry/really_i_dont_feel_like_thinki,1858,0,0,0,0
May 9 2009,Snively '11,What now suckas!?,http://mitadmissions.org/blogs/entry/what_now_suckas,1860,0,0,0,0
May 9 2009,Yan Z. '12,A Brief History of Thursday,http://mitadmissions.org/blogs/entry/post_19,1860,0,0,0,0
May 8 2009,Matt McGann '00,Info for the Class of 2013,http://mitadmissions.org/blogs/entry/info_for_the_class_of_2013,1861,1,0,0,1
May 4 2009,Chris S. '11,My Shortest Blog Ever (update 3 =p),http://mitadmissions.org/blogs/entry/shortest_blog_ever,1865,0,0,0,0
May 3 2009,Snively '11,Im on a boat!,http://mitadmissions.org/blogs/entry/im_on_a_boat,1866,0,0,0,0
May 1 2009,Bryan O. '09,The Other CPW,http://mitadmissions.org/blogs/entry/the_other_cpw,1868,0,0,0,0
May 1 2009,Matt McGann '00,This is Jeopardy! [UPDATE],http://mitadmissions.org/blogs/entry/this_is_jeopardy,1868,0,0,0,0
Apr 30 2009,Laura N. '09,This week in verse,http://mitadmissions.org/blogs/entry/this_week_in_verse,1869,0,0,0,0
Apr 30 2009,Snively '11,An Explanation,http://mitadmissions.org/blogs/entry/an_explanation,1869,0,0,0,0
Apr 29 2009,Yan Z. '12,CPW Photograph-athon,http://mitadmissions.org/blogs/entry/cpw_photographathon_1,1870,0,0,0,0
Apr 29 2009,Snively '11,Shelbys Amazing CPW Adventure,http://mitadmissions.org/blogs/entry/shelbys_amazing_cpw_adventure,1870,0,0,0,0
Apr 28 2009,Snively '11,Hack Safari,http://mitadmissions.org/blogs/entry/hack_safari,1871,0,0,0,0
Apr 27 2009,Matt McGann '00,Tattoo ideas,http://mitadmissions.org/blogs/entry/tattoo_ideas_1,1872,0,0,0,0
Apr 27 2009,Matt McGann '00,Waitlist and transfer: quick update,http://mitadmissions.org/blogs/entry/waitlist_and_transfer_quick_up,1872,0,0,0,0
Apr 24 2009,Chris M. '12,Support MIT Sports!!,http://mitadmissions.org/blogs/entry/support_mit_sports,1875,0,0,0,0
Apr 24 2009,Snively '11,Practice Safe Hacking,http://mitadmissions.org/blogs/entry/practice_safe_hacking,1875,2,4,1,7
Apr 23 2009,Paul B. '11,Got Questions?,http://mitadmissions.org/blogs/entry/got_questions,1876,0,0,0,0
Apr 22 2009,Snively '11,Mind Dump (Episode 4),http://mitadmissions.org/blogs/entry/mind_dump_pilot,1877,0,0,0,0
Apr 21 2009,Matt McGann '00,"CPW, making a decision, and saying yes/no",http://mitadmissions.org/blogs/entry/cpw_making_a_decision_and_sayi,1878,0,0,0,0
Apr 20 2009,Kim D. '09,Patriots Day,http://mitadmissions.org/blogs/entry/patriots_day,1879,0,0,0,0
Apr 20 2009,Yan Z. '12,CPW roundup,http://mitadmissions.org/blogs/entry/cpw_roundup,1879,0,0,0,0
Apr 19 2009,Chris S. '11,On MIT and Humanities,http://mitadmissions.org/blogs/entry/on_mit_and_humanities,1880,9,3,0,12
Apr 18 2009,Matt McGann '00,HS Juniors/Sophomores: Upcoming MIT Events,http://mitadmissions.org/blogs/entry/hs_juniorssophomores_upcoming,1881,0,0,0,0
Apr 16 2009,Chris M. '12,ZOMG CPW and other acronyms,http://mitadmissions.org/blogs/entry/zomg_cpw_and_other_acronyms,1883,0,0,0,0
Apr 15 2009,Matt McGann '00,What to expect when youre expecting CPW,http://mitadmissions.org/blogs/entry/what_to_expect_when_youre_expe_1,1884,0,0,0,0
Apr 15 2009,Mikey Yang '05,The Calm Before the Storm,http://mitadmissions.org/blogs/entry/the_calm_before_the_storm,1884,0,0,0,0
Apr 14 2009,Ahmed H. '12,"Where Youre Going, Where Ive Been",http://mitadmissions.org/blogs/entry/where_youre_going_and_where_iv_1,1885,0,0,0,0
Apr 14 2009,Chris S. '11,Leadership Training Institute,http://mitadmissions.org/blogs/entry/leadership_training_institute_1,1885,0,0,0,0
Apr 14 2009,Snively '11,We Want You!,http://mitadmissions.org/blogs/entry/we_want_you,1885,0,0,0,0
Apr 14 2009,Daniel Barkowitz,The Tax Man Cometh,http://mitadmissions.org/blogs/entry/the_tax_man_cometh,1885,0,0,0,0
Apr 14 2009,ARTalk,Singing with a Local Filk Group,http://mitadmissions.org/blogs/entry/singing_with_a_local_filk_grou,1885,0,0,0,0
Apr 14 2009,Kim Hunter '86,CPW is for Parents Too,http://mitadmissions.org/blogs/entry/cpw_is_for_parents_too_1,1885,0,0,0,0
Apr 14 2009,Laura N. '09,Nerdy adventures on the West Coast,http://mitadmissions.org/blogs/entry/nerdy_adventures_on_the_west_c,1885,0,0,0,0
Apr 13 2009,Daniel Barkowitz,Getting ready for CPW,http://mitadmissions.org/blogs/entry/getting_ready_for_cpw,1886,0,0,0,0
Apr 13 2009,Yan Z. '12,Eternal sunshine of the sleepless mind,http://mitadmissions.org/blogs/entry/eternal_sunshine_of_the_sleepl_1,1886,0,0,0,0
Apr 10 2009,Daniel Barkowitz,Spring Means New Beginnings,http://mitadmissions.org/blogs/entry/spring_means_new_beginnings,1889,0,0,0,0
Apr 9 2009,Chris M. '12,IM BACK!!!,http://mitadmissions.org/blogs/entry/im_back_2,1890,0,0,0,0
Apr 8 2009,Matt McGann '00,Chocolate!!!,http://mitadmissions.org/blogs/entry/chocolate,1891,0,1,0,1
Apr 7 2009,Snively '11,Red Sox,http://mitadmissions.org/blogs/entry/red_sox,1892,0,0,0,0
Apr 6 2009,Yan Z. '12,Springtime,http://mitadmissions.org/blogs/entry/springtime,1893,0,0,0,0
Apr 6 2009,Chris S. '11,The Value of Creativity,http://mitadmissions.org/blogs/entry/the_value_of_creativity,1893,28,8,9,45
Apr 2 2009,Shannon M. '12,Decide my major!,http://mitadmissions.org/blogs/entry/vote_on_my_major,1897,0,0,0,0
Apr 2 2009,Lulu L. '09,Inherent Asymmetry,http://mitadmissions.org/blogs/entry/inherent_asymmetry,1897,0,0,0,0
Apr 1 2009,ARTalk,How to get around MIT hunger pangs,http://mitadmissions.org/blogs/entry/how_to_get_around_mit_hunger_p,1898,0,0,0,0
Apr 1 2009,Snively '11,MIT is Hacked,http://mitadmissions.org/blogs/entry/mit_is_hacked,1898,0,0,0,0
Mar 31 2009,Cristen C. '10,Fresh Food!,http://mitadmissions.org/blogs/entry/fresh_food,1899,0,0,0,0
Mar 29 2009,Stu Schmill '86,Some reflections,http://mitadmissions.org/blogs/entry/some_reflections,1901,0,0,0,0
Mar 28 2009,Snively '11,Friendship,http://mitadmissions.org/blogs/entry/friendship,1902,0,0,0,0
Mar 27 2009,Mikey Yang '05,Sixth Sense,http://mitadmissions.org/blogs/entry/sixth_sense,1903,0,0,0,0
Mar 26 2009,Yan Z. '12,New York,http://mitadmissions.org/blogs/entry/new_york_1,1904,0,0,0,0
Mar 26 2009,Paul B. '11,MIT Talks Energy at the White House,http://mitadmissions.org/blogs/entry/mit_at_the_white_house,1904,0,0,0,0
Mar 25 2009,Snively '11,College Fair!,http://mitadmissions.org/blogs/entry/college_fair,1905,0,0,0,0
Mar 24 2009,Kim Hunter '86,Admitted Students Meetings,http://mitadmissions.org/blogs/entry/admitted_students_meetings,1906,0,0,0,0
Mar 24 2009,ARTalk,Writing Science Fiction,http://mitadmissions.org/blogs/entry/writing_science_fiction,1906,0,0,0,0
Mar 21 2009,Yan Z. '12,College,http://mitadmissions.org/blogs/entry/college,1909,0,0,0,0
Mar 21 2009,Chris S. '11,Thank Goodness!,http://mitadmissions.org/blogs/entry/thank_goodness,1909,0,0,0,0
Mar 20 2009,Kim D. '09,Come to MIT,http://mitadmissions.org/blogs/entry/come_to_mit,1910,0,0,0,0
Mar 20 2009,Cristen C. '10,Spring Break!,http://mitadmissions.org/blogs/entry/spring_break_2,1910,0,0,0,0
Mar 18 2009,Daniel Barkowitz,The letter is in the mail (UPDATED),http://mitadmissions.org/blogs/entry/the_letter_is_in_the_mail_1,1912,0,1,0,1
Mar 17 2009,Matt McGann '00,More Information on the Waitlist,http://mitadmissions.org/blogs/entry/more_information_on_the_waitli,1913,0,0,0,0
Mar 17 2009,ARTalk,SEEGGGGGAAAAAAA!,http://mitadmissions.org/blogs/entry/seegggggaaaaaaa_1,1913,0,0,0,0
Mar 16 2009,Matt McGann '00,Admitted Students Update,http://mitadmissions.org/blogs/entry/admitted_students_update_1,1914,1,0,0,1
Mar 16 2009,Paul B. '11,Were Linux!,http://mitadmissions.org/blogs/entry/were_linux,1914,0,0,0,0
Mar 16 2009,Chris S. '11,For the Admitted Students,http://mitadmissions.org/blogs/entry/for_the_admitted_students_1,1914,0,0,0,0
Mar 16 2009,Chris S. '11,For the Not Admitted Students,http://mitadmissions.org/blogs/entry/for_the_not_admitted_students,1914,6,1,4,11
Mar 14 2009,Decisions,MIT Regular Action Admissions Decisions Available Online,http://mitadmissions.org/blogs/entry/mit_regular_action_admissions,1916,0,0,0,0
Mar 14 2009,Decisions,Open Forum for Admitted Students,http://mitadmissions.org/blogs/entry/open_forum_for_admitted_studen,1916,0,1,1,2
Mar 14 2009,Decisions,Open Forum for those Not Admitted,http://mitadmissions.org/blogs/entry/open_forum_for_those_not_admit,1916,0,0,0,0
Mar 14 2009,Decisions,Open Forum for Waitlisted Students,http://mitadmissions.org/blogs/entry/open_forum_for_waitlisted_stud,1916,0,0,0,0
Mar 14 2009,Snively '11,One last bit of advice,http://mitadmissions.org/blogs/entry/one_last_bit_of_advice,1916,0,0,0,0
Mar 13 2009,Chris M. '12,About Tomorrow,http://mitadmissions.org/blogs/entry/about_tomorrow,1917,1,0,0,1
Mar 13 2009,Yan Z. '12,This entry has a surprise ending,http://mitadmissions.org/blogs/entry/this_entry_has_a_surprise_endi,1917,0,0,0,0
Mar 12 2009,Kim Hunter '86,This One is for the Families,http://mitadmissions.org/blogs/entry/this_one_is_for_the_families_1,1918,0,0,0,0
Mar 11 2009,Kim D. '09,Do you live in Zambia? Malawi? Ghana?,http://mitadmissions.org/blogs/entry/do_you_live_in_zambia_malawi_g,1919,1,0,0,1
Mar 11 2009,Chris S. '11,Just a Yellow Lemon Tree,http://mitadmissions.org/blogs/entry/just_a_yellow_lemon_tree,1919,0,0,0,0
Mar 10 2009,Mikey Yang '05,I have such cool friends!,http://mitadmissions.org/blogs/entry/i_have_such_cool_friends,1920,0,0,0,0
Mar 10 2009,Shannon M. '12,A little something while you wait.,http://mitadmissions.org/blogs/entry/a_little_something_while_you_w,1920,0,0,0,0
Mar 9 2009,Matt McGann '00,Regular Action Decisions: Saturday 3/14,http://mitadmissions.org/blogs/entry/regular_action_decisions_satur,1921,0,0,0,0
Mar 9 2009,Paul B. '11,Nano @ MIT,http://mitadmissions.org/blogs/entry/nano_mit,1921,1,1,0,2
Mar 9 2009,Snively '11,Not here!,http://mitadmissions.org/blogs/entry/not_here,1921,0,0,0,0
Mar 9 2009,Keri G. '10,I hurt myself again,http://mitadmissions.org/blogs/entry/i_hurt_myself_again,1921,0,0,0,0
Mar 6 2009,Chris M. '12,Hosed,http://mitadmissions.org/blogs/entry/hosed_1,1924,0,0,0,0
Mar 5 2009,Keri G. '10,ILGs at MIT,http://mitadmissions.org/blogs/entry/ilgs_at_mit,1925,1,1,0,2
Mar 4 2009,Yan Z. '12,A Run through Boston,http://mitadmissions.org/blogs/entry/a_run_through_boston,1926,0,0,0,0
Mar 3 2009,Paul B. '11,Square Root Day,http://mitadmissions.org/blogs/entry/square_root_day,1927,0,0,0,0
Mar 2 2009,Paul B. '11,Snow Day? No Way!,http://mitadmissions.org/blogs/entry/snow_day_no_way,1928,0,0,0,0
Mar 2 2009,Shannon M. '12,Snow snow snow.,http://mitadmissions.org/blogs/entry/snow_snow_snow_1,1928,0,0,0,0
Mar 2 2009,Snively '11,Dorm Bathrooms,http://mitadmissions.org/blogs/entry/dorm_bathrooms,1928,0,7,0,7
Mar 1 2009,Laura N. '09,Winter Storm Warning,http://mitadmissions.org/blogs/entry/winter_storm_warning,1929,0,0,0,0
Feb 27 2009,Snively '11,Things You Shouldnt Do,http://mitadmissions.org/blogs/entry/things_you_shouldnt_do,1931,0,0,0,0
Feb 27 2009,Chris M. '12,Montreal a.k.a my awesome birthday blog a.k.a the end of IAP,http://mitadmissions.org/blogs/entry/montreal_aka_my_awesome_birthd,1931,0,0,0,0
Feb 25 2009,Jess K. '10,IAP and Igloos,http://mitadmissions.org/blogs/entry/iap_and_igloos,1933,0,0,0,0
Feb 24 2009,Matt McGann '00,February updates,http://mitadmissions.org/blogs/entry/february_updates,1934,0,0,0,0
Feb 24 2009,Laura N. '09,The rest of my life,http://mitadmissions.org/blogs/entry/the_rest_of_my_life,1934,0,0,0,0
Feb 24 2009,Yan Z. '12,Its Monday,http://mitadmissions.org/blogs/entry/its_monday,1934,2,1,2,5
Feb 23 2009,Laura N. '09,The Rainbow Lounge,http://mitadmissions.org/blogs/entry/the_rainbow_lounge,1935,0,0,0,0
Feb 20 2009,Laura N. '09,Things that are awesome,http://mitadmissions.org/blogs/entry/things_that_are_awesome,1938,0,0,0,0
Feb 19 2009,Daniel Barkowitz,I Can See Clearly Now,http://mitadmissions.org/blogs/entry/i_can_see_clearly_now,1939,0,0,0,0
Feb 19 2009,Keri G. '10,Things that Scare Me,http://mitadmissions.org/blogs/entry/things_that_scare_me,1939,0,0,0,0
Feb 18 2009,Laura N. '09,Reg Day collisions,http://mitadmissions.org/blogs/entry/reg_day_collisions,1940,0,0,0,0
Feb 17 2009,Kim D. '09,To D or not to D?,http://mitadmissions.org/blogs/entry/to_d_or_not_to_d,1941,0,0,0,0
Feb 16 2009,Lulu L. '09,My schedule,http://mitadmissions.org/blogs/entry/my_schedule,1942,0,0,0,0
Feb 14 2009,Yan Z. '12,Valentines Day Special,http://mitadmissions.org/blogs/entry/valentines_day_special_1,1944,0,0,0,0
Feb 14 2009,Snively '11,Special Edition!,http://mitadmissions.org/blogs/entry/special_edition,1944,0,0,0,0
Feb 14 2009,Shannon M. '12,MIT Admissions ,http://mitadmissions.org/blogs/entry/mit_admissions_3,1944,0,0,0,0
Feb 13 2009,Shannon M. '12,Valentines Day Eve Day. What?,http://mitadmissions.org/blogs/entry/i_need_to_stop_posting_about_c,1945,0,0,0,0
Feb 13 2009,Daniel Barkowitz,"Deadline, Schmedline",http://mitadmissions.org/blogs/entry/deadline_schmedline,1945,0,0,0,0
Feb 13 2009,Daniel Barkowitz,Six Word Memoirs. Want to Play?,http://mitadmissions.org/blogs/entry/six_word_memoirs_want_to_play,1945,0,0,0,0
Feb 13 2009,Cristen C. '10,My Schedule Is Awesome,http://mitadmissions.org/blogs/entry/my_schedule_is_awesome,1945,0,0,0,0
Feb 13 2009,Cristen C. '10,The Places Youll Go,http://mitadmissions.org/blogs/entry/the_places_youll_go_1,1945,0,0,0,0
Feb 12 2009,Snively '11,Freebie Part II,http://mitadmissions.org/blogs/entry/freebie_part_ii,1946,0,0,0,0
Feb 11 2009,Paul B. '11,MITblogs: The Next Generation,http://mitadmissions.org/blogs/entry/mitblogs_the_next_generation,1947,0,0,0,0
Feb 10 2009,Yan Z. '12,Not a Real Entry,http://mitadmissions.org/blogs/entry/not_a_real_entry,1948,0,0,0,0
Feb 9 2009,Chris S. '11,The 2011 Brass Rat!,http://mitadmissions.org/blogs/entry/the_2011_brass_rat,1949,0,0,0,0
Feb 9 2009,Matt McGann '00,A bevy of beautiful Brass Rat bezels,http://mitadmissions.org/blogs/entry/a_bevy_of_beautiful_brass_rat_1,1949,0,0,0,0
Feb 9 2009,Snively '11,Today,http://mitadmissions.org/blogs/entry/today,1949,0,0,0,0
Feb 6 2009,Matt McGann '00,"N.Y. Times, Page B11: MIT Guard Shows Brains and Hoops Can Mix",http://mitadmissions.org/blogs/entry/ny_times_page_b11_mit_guard_sh,1952,0,0,0,0
Feb 5 2009,Chris S. '11,101 Things About Tokyo (Pt. 2),http://mitadmissions.org/blogs/entry/101_things_about_tokyo_pt_2,1953,0,0,0,0
Feb 3 2009,Shannon M. '12,25 things and another reason to come to CPW.,http://mitadmissions.org/blogs/entry/25_things_and_another_reason_t,1955,0,0,0,0
Feb 3 2009,Paul B. '11,As Winter Melts,http://mitadmissions.org/blogs/entry/as_winter_melts,1955,0,0,0,0
Feb 2 2009,Yan Z. '12,Integration Bee,http://mitadmissions.org/blogs/entry/integration_bee,1956,1,2,0,3
Feb 2 2009,Daniel Barkowitz,Its February 2nd Do you know where your FAFSA is?,http://mitadmissions.org/blogs/entry/its_february_2nd_do_you_know_w,1956,0,0,0,0
Feb 1 2009,Snively '11,A Conner 2 Trip to the North End,http://mitadmissions.org/blogs/entry/a_conner_2_trip_to_the_north_e,1957,0,0,0,0
Jan 31 2009,Matt McGann '00,"Nadal, Federer, Helfant 85",http://mitadmissions.org/blogs/entry/nadal_federer_helfant_85,1958,0,0,0,0
Jan 29 2009,Snively '11,2.670 Wrapup,http://mitadmissions.org/blogs/entry/2670_wrapup,1960,0,0,0,0
Jan 28 2009,Yan Z. '12,This title is irrelevant,http://mitadmissions.org/blogs/entry/this_title_is_irrelevant_1,1961,0,0,0,0
Jan 28 2009,Matt McGann '00,Application Tracking now available,http://mitadmissions.org/blogs/entry/application_tracking_now_avail,1961,0,0,0,0
Jan 27 2009,Chris M. '12,IAP: A Quick Roundup,http://mitadmissions.org/blogs/entry/iap_a_quick_roundup,1962,0,0,0,0
Jan 27 2009,Lulu L. '09,I wake to sleep,http://mitadmissions.org/blogs/entry/i_wake_to_sleep,1962,0,0,0,0
Jan 26 2009,Quinton McArthur,"Stomp the Yard, MIT style",http://mitadmissions.org/blogs/entry/stomp_the_yard_mit_style,1963,0,0,0,0
Jan 25 2009,Snively '11,All About Toys,http://mitadmissions.org/blogs/entry/all_about_toys,1964,0,0,0,0
Jan 25 2009,Snively '11,Lets Build a Snowman [CRITICAL UPDATE!],http://mitadmissions.org/blogs/entry/lets_build_a_snowman,1964,0,0,0,0
Jan 25 2009,Shannon M. '12,So lets build a snowman. In the moat.,http://mitadmissions.org/blogs/entry/so_lets_build_a_snowman_in_the,1964,0,0,0,0
Jan 22 2009,Snively '11,IAP: The Class Edition,http://mitadmissions.org/blogs/entry/iap_the_class_edition,1967,0,0,0,0
Jan 21 2009,Yan Z. '12,Good Will Mystery Hunting,http://mitadmissions.org/blogs/entry/good_will_mystery_hunting,1968,0,0,0,0
Jan 20 2009,Shannon M. '12,Today is a Super Important Day,http://mitadmissions.org/blogs/entry/today_is_a_super_important_day_1,1969,0,0,0,0
Jan 15 2009,Snively '11,EA Telethon,http://mitadmissions.org/blogs/entry/ea_telethon_1,1974,0,0,0,0
Jan 13 2009,Yan Z. '12,Yet Another Blog Entry,http://mitadmissions.org/blogs/entry/yet_another_blog_entry_1,1976,0,0,0,0
Jan 13 2009,Chris S. '11,101 Things About Tokyo (Pt. 1),http://mitadmissions.org/blogs/entry/101_things_about_tokyo_pt_1,1976,0,0,0,0
Jan 12 2009,Snively '11,Livescribes Pulse Pen,http://mitadmissions.org/blogs/entry/livescribes_pulse_pen,1977,0,0,0,0
Jan 12 2009,Paul B. '11,IAP in Review: Week One,http://mitadmissions.org/blogs/entry/iap_week_one,1977,0,0,0,0
Jan 12 2009,Keri G. '10,Im still here (and MITs still hard),http://mitadmissions.org/blogs/entry/im_still_here_and_mits_still_h,1977,0,0,0,0
Jan 11 2009,Chris M. '12,IM BACK!!!!! (and MIT is hard),http://mitadmissions.org/blogs/entry/im_back_and_mit_is_hard,1978,0,0,0,0
Jan 6 2009,Yan Z. '12,Guest Blog: From the Life and Times of Cam,http://mitadmissions.org/blogs/entry/guest_blog_from_the_life_and_t,1983,0,0,0,0
Jan 6 2009,Snively '11,Working at a Toy Company!,http://mitadmissions.org/blogs/entry/friday_at_work,1983,0,0,0,0
Jan 5 2009,Shannon M. '12,How I got mugged in the frozen foods section.,http://mitadmissions.org/blogs/entry/how_i_got_mugged_in_the_frozen,1984,0,0,0,0
Jan 4 2009,Snively '11,A Word of Warning (Pay Attention),http://mitadmissions.org/blogs/entry/a_word_of_warning_pay_attentio,1985,0,0,0,0
Jan 3 2009,Matt McGann '00,MIT Regular Action Deadline Extended to January 3,http://mitadmissions.org/blogs/entry/mit_regular_action_deadline_ex,1986,0,0,0,0
Jan 2 2009,The Humanitarian Blog,Im in Round 2! Can You Help Me Make the Top 10?,http://mitadmissions.org/blogs/entry/im_in_round_2_can_you_help_me,1987,0,0,0,0
Jan 2 2009,Melis A. '08,Whats new?,http://mitadmissions.org/blogs/entry/whats_new,1987,0,1,0,1
Jan 2 2009,Snively '11,Dining,http://mitadmissions.org/blogs/entry/dining,1987,0,0,0,0
Jan 1 2009,Kim Hunter '86,My Guilty Pleasure,http://mitadmissions.org/blogs/entry/let_it_snow_let_it_snow_let_it,1988,0,0,0,0
Jan 1 2009,Yan Z. '12,Questions? Answers.,http://mitadmissions.org/blogs/entry/questions_answers,1988,0,0,0,0
Jan 1 2009,Mikey Yang '05,Happy New Year!,http://mitadmissions.org/blogs/entry/happy_new_year_1,1988,0,1,0,1
Dec 31 2008,Ahmed H. '12,Quick Update,http://mitadmissions.org/blogs/entry/quick_update_3,1989,0,0,0,0
Dec 31 2008,Snively '11,Canceled?,http://mitadmissions.org/blogs/entry/canceled,1989,0,0,0,0
Dec 31 2008,Paul B. '11,Save Point,http://mitadmissions.org/blogs/entry/save_point,1989,0,1,1,2
Dec 31 2008,Keri G. '10,"Waxing nostalgic, in a zen kind of way",http://mitadmissions.org/blogs/entry/waxing_nostalgic_in_a_zen_kind,1989,0,0,0,0
Dec 30 2008,Quinton McArthur,Things that make you go hmmmm....,http://mitadmissions.org/blogs/entry/things_that_make_you_go_hmmmm,1990,0,0,0,0
Dec 29 2008,Matt McGann '00,MIT Regular Action Deadline,http://mitadmissions.org/blogs/entry/mit_regular_action_deadline,1991,0,0,0,0
Dec 28 2008,Lulu L. '09,This will default to miscellaneous,http://mitadmissions.org/blogs/entry/this_will_default_to_miscellan,1992,0,0,0,0
Dec 28 2008,Cristen C. '10,The School of Architecture + Planning,http://mitadmissions.org/blogs/entry/the_school_of_architecture_pla,1992,0,0,0,0
Dec 27 2008,Mollie B. '06,neighborhoods we move into and come to love.,http://mitadmissions.org/blogs/entry/neighborhoodswe_move_into_and_1,1993,0,0,0,0
Dec 24 2008,Snively '11,"Parents, Please Read",http://mitadmissions.org/blogs/entry/parents_please_read,1996,4,5,0,9
Dec 24 2008,Kim D. '09,I am home. Small thanks to the Airlines.,http://mitadmissions.org/blogs/entry/holidaytravel08,1996,0,0,0,0
Dec 24 2008,Lulu L. '09,Im in New York,http://mitadmissions.org/blogs/entry/im_in_new_york,1996,0,0,0,0
Dec 24 2008,Mikey Yang '05,Mikeys Meta TV Post,http://mitadmissions.org/blogs/entry/mikeys_meta_tv_post,1996,0,0,0,0
Dec 23 2008,Yan Z. '12,Recollections of a Stranded Traveler,http://mitadmissions.org/blogs/entry/recollections_of_a_stranded_tr,1997,0,0,0,0
Dec 22 2008,Keri G. '10,In which I am a bad example,http://mitadmissions.org/blogs/entry/in_which_i_am_a_bad_example_2,1998,0,0,0,0
Dec 21 2008,Chris S. '11,Well I Know That Its a Wonderful World,http://mitadmissions.org/blogs/entry/well_i_know_that_its_a_wonderf,1999,0,0,0,0
Dec 20 2008,Snively '11,"Finals Week, from my perspective",http://mitadmissions.org/blogs/entry/finals_week_from_my_perspectiv,2000,0,0,0,0
Dec 19 2008,Lulu L. '09,Over here,http://mitadmissions.org/blogs/entry/over_here,2001,0,0,0,0
Dec 19 2008,The Humanitarian Blog,Please Vote for My Idea for the Obama Administration!,http://mitadmissions.org/blogs/entry/please_vote_for_my_idea_for_th,2001,0,0,0,0
Dec 19 2008,Yan Z. '12,The Finals Blog,http://mitadmissions.org/blogs/entry/the_finals_blog,2001,0,0,0,0
Dec 17 2008,Snively '11,The Final Push,http://mitadmissions.org/blogs/entry/the_final_push,2003,0,0,0,0
Dec 17 2008,Matt McGann '00,For EA Deferred Students,http://mitadmissions.org/blogs/entry/for_ea_deferred_students_1,2003,0,0,0,0
Dec 15 2008,Decisions,MIT Early Action Admissions Decisions Available Online,http://mitadmissions.org/blogs/entry/mit_early_action_admissions_de,2005,0,0,0,0
Dec 15 2008,Decisions,Admitted,http://mitadmissions.org/blogs/entry/admitted_5,2005,0,0,0,0
Dec 15 2008,Decisions,Deferred,http://mitadmissions.org/blogs/entry/deferred_3,2005,0,0,0,0
Dec 15 2008,Decisions,Not Admitted,http://mitadmissions.org/blogs/entry/not_admitted_4,2005,0,1,0,1
Dec 15 2008,Shannon M. '12,Twas the Night before Finals,http://mitadmissions.org/blogs/entry/twas_the_night_before_finals,2005,1,2,1,4
Dec 15 2008,Paul B. '11,Distractions,http://mitadmissions.org/blogs/entry/distractions,2005,1,1,0,2
Dec 13 2008,Yan Z. '12,Life during finals season,http://mitadmissions.org/blogs/entry/life_during_finals_season,2007,0,0,0,0
Dec 12 2008,Chris S. '11,"Otra Vez, Como Siempre",http://mitadmissions.org/blogs/entry/otra_vez_como_siempre,2008,0,0,0,0
Dec 11 2008,Ahmed H. '12,A Latino Christmas,http://mitadmissions.org/blogs/entry/a_latino_christmas,2009,0,0,0,0
Dec 10 2008,Matt McGann '00,Early Action Decisions,http://mitadmissions.org/blogs/entry/early_action_decisions_1,2010,0,0,0,0
Dec 10 2008,Snively '11,A Christmas Hug [UPDATE: New picture!!!],http://mitadmissions.org/blogs/entry/a_christmas_hug,2010,0,0,0,0
Dec 10 2008,Shannon M. '12,THIS. IS. 18.02.,http://mitadmissions.org/blogs/entry/this_is_1802,2010,0,0,0,0
Dec 9 2008,Chris S. '11,A HASS[le-free] Semester,http://mitadmissions.org/blogs/entry/a_hasslefree_semester,2011,0,0,0,0
Dec 9 2008,Lulu L. '09,"Syzygy, basically.",http://mitadmissions.org/blogs/entry/syzygy_basically,2011,0,0,0,0
Dec 8 2008,Matt McGann '00,EA Update,http://mitadmissions.org/blogs/entry/ea_update,2012,0,0,0,0
Dec 7 2008,Laura N. '09,Hosed,http://mitadmissions.org/blogs/entry/hosed,2013,0,0,0,0
Dec 6 2008,Yan Z. '12,Day in the Life,http://mitadmissions.org/blogs/entry/day_in_the_life,2014,0,0,0,0
Dec 2 2008,Kim D. '09,Think Happy Thoughts,http://mitadmissions.org/blogs/entry/think_happy_thoughts_1,2018,0,0,0,0
Dec 1 2008,Matt McGann '00,To-Do List for Regular Action Applicants,http://mitadmissions.org/blogs/entry/todo_list_for_regular_action_a,2019,0,0,0,0
Dec 1 2008,Snively '11,World AIDS Day 2008,http://mitadmissions.org/blogs/entry/world_aids_day_2008,2019,0,0,0,0
Nov 30 2008,Chris M. '12,"Youve got questions, Ive got answers",http://mitadmissions.org/blogs/entry/youve_got_questions_ive_got_an_1,2020,0,0,0,0
Nov 29 2008,Yan Z. '12,Thoughts on coming home,http://mitadmissions.org/blogs/entry/thoughts_on_coming_home,2021,0,0,0,0
Nov 27 2008,Shannon M. '12,A Burton Jew Thanksgiving,http://mitadmissions.org/blogs/entry/a_burton_jew_thanksgiving,2023,0,0,0,0
Nov 27 2008,Snively '11,Gobble Gobble,http://mitadmissions.org/blogs/entry/gobble_gobble,2023,0,0,0,0
Nov 27 2008,Laura N. '09,American culture at its finest: Thanksgiving,http://mitadmissions.org/blogs/entry/american_culture_at_its_finest,2023,0,2,0,2
Nov 25 2008,Yan Z. '12,A word about the humanities,http://mitadmissions.org/blogs/entry/a_word_about_the_humanities,2025,1,0,0,1
Nov 25 2008,Paul B. '11,"Lost, Hosed & Confused",http://mitadmissions.org/blogs/entry/lost_hosed_confused,2025,0,0,0,0
Nov 24 2008,Matt McGann '00,2 More MIT Students Become Rhodes Scholars,http://mitadmissions.org/blogs/entry/2_more_mit_students_become_rho,2026,0,0,0,0
Nov 24 2008,Snively '11,Boing! Boing!,http://mitadmissions.org/blogs/entry/boing_boing_1,2026,0,0,0,0
Nov 23 2008,Chris S. '11,15.27182 - Lecture Anatomy 101,http://mitadmissions.org/blogs/entry/1527182_lecture_anatomy_101,2027,0,0,0,0
Nov 23 2008,Laura N. '09,The Stuff of MIT Legend,http://mitadmissions.org/blogs/entry/super_cool_story,2027,0,0,0,0
Nov 22 2008,Shannon M. '12,Of Orange Juice and Animal Hats.,http://mitadmissions.org/blogs/entry/of_orange_juice_and_animal_hat,2028,0,0,0,0
Nov 22 2008,Laura N. '09,Anatomy of a college students life,http://mitadmissions.org/blogs/entry/anatomy_of_a_college_students,2028,0,0,0,0
Nov 21 2008,Daniel Barkowitz,"Red Lines, Death Vows, Foreclosures, Risk Structures",http://mitadmissions.org/blogs/entry/red_lines_death_vows_foreclosu,2029,0,0,0,0
Nov 21 2008,Matt McGann '00,EA Tracking update,http://mitadmissions.org/blogs/entry/ea_tracking_update,2029,0,0,0,0
Nov 21 2008,Snively '11,Appetizer,http://mitadmissions.org/blogs/entry/appetizer,2029,0,0,0,0
Nov 20 2008,Lulu L. '09,The sun is out,http://mitadmissions.org/blogs/entry/the_sun_is_out,2030,0,0,0,0
Nov 20 2008,Paul B. '11,Exponential Decay,http://mitadmissions.org/blogs/entry/exponential_decay,2030,0,0,0,0
Nov 19 2008,Snively '11,Two Things,http://mitadmissions.org/blogs/entry/two_things,2031,0,0,0,0
Nov 18 2008,Laura N. '09,Making money: my campus job,http://mitadmissions.org/blogs/entry/making_money_my_campus_job,2032,0,0,0,0
Nov 18 2008,Chris S. '11,When Econ Comes to Life,http://mitadmissions.org/blogs/entry/when_econ_comes_to_life,2032,0,0,0,0
Nov 17 2008,Ahmed H. '12,Snapshot of a Week,http://mitadmissions.org/blogs/entry/snapshot,2033,0,0,0,0
Nov 17 2008,Yan Z. '12,A major problem is not a major problem,http://mitadmissions.org/blogs/entry/a_major_problem_is_not_a_major,2033,0,0,0,0
Nov 17 2008,Daniel Barkowitz,Letter to the community on MIT finances,http://mitadmissions.org/blogs/entry/letter_to_the_community_on_mit,2033,0,0,0,0
Nov 17 2008,Kim D. '09,Ive got Mail! And a LAPTOP!,http://mitadmissions.org/blogs/entry/ive_got_mail_and_a_laptop,2033,0,0,0,0
Nov 17 2008,Paul B. '11,Anatomy of a Late Night,http://mitadmissions.org/blogs/entry/anatomy_of_a_late_night,2033,0,0,0,0
Nov 16 2008,Laura N. '09,"Life, the Universe, and the Energy Content of Gasoline",http://mitadmissions.org/blogs/entry/life_the_universe_and_the_ener,2034,0,0,0,0
Nov 14 2008,Snively '11,The Evolution of Physics,http://mitadmissions.org/blogs/entry/the_evolution_of_physics,2036,1,0,0,1
Nov 14 2008,Paul B. '11,Warning: Contains Biology,http://mitadmissions.org/blogs/entry/one_night_in_course_20,2036,0,0,0,0
Nov 13 2008,Snively '11,We Treat You Nicely,http://mitadmissions.org/blogs/entry/we_treat_you_nicely,2037,0,0,0,0
Nov 12 2008,Matt McGann '00,Admissions updates,http://mitadmissions.org/blogs/entry/admissions_updates_1,2038,0,0,0,0
Nov 12 2008,ARTalk,FASAP,http://mitadmissions.org/blogs/entry/fasap,2038,0,2,0,2
Nov 12 2008,Yan Z. '12,Odds and ends and Canada,http://mitadmissions.org/blogs/entry/odds_and_ends_and_canada,2038,0,0,0,0
Nov 11 2008,Chris S. '11,The College Essay: Yogurt Edition!,http://mitadmissions.org/blogs/entry/the_college_essay_yogurt_editi,2039,31,30,29,90
Nov 11 2008,Snively '11,Overheard at MIT,http://mitadmissions.org/blogs/entry/overheard_at_mit,2039,0,1,0,1
Nov 10 2008,Laura N. '09,The story of the most epic pset ever,http://mitadmissions.org/blogs/entry/the_story_of_the_most_epic_pse,2040,0,0,0,0
Nov 10 2008,Kim D. '09,The MIT What?!?,http://mitadmissions.org/blogs/entry/the_mit_what,2040,0,0,0,0
Nov 10 2008,Paul B. '11,Observations of an MIT Sophomore,http://mitadmissions.org/blogs/entry/observations_of_an_mit_sophomore,2040,0,0,0,0
Nov 9 2008,Laura N. '09,My Halloween Costume is Better Than Yours,http://mitadmissions.org/blogs/entry/my_halloween_costume_is_better,2041,0,0,0,0
Nov 8 2008,Paul B. '11,"Halloween, Part 2",http://mitadmissions.org/blogs/entry/halloween_part_2,2042,0,0,0,0
Nov 7 2008,Snively '11,Blogging Scholarship,http://mitadmissions.org/blogs/entry/blogging_scholarship,2043,1,0,0,1
Nov 6 2008,Yan Z. '12,Re-halloween,http://mitadmissions.org/blogs/entry/rehalloween,2044,0,0,0,0
Nov 6 2008,Snively '11,A Picture is Worth a Thousand Words,http://mitadmissions.org/blogs/entry/a_picture_is_worth_a_thousand_1,2044,0,0,0,0
Nov 6 2008,ARTalk,Large Format Photography,http://mitadmissions.org/blogs/entry/large_format_photography,2044,1,1,0,2
Nov 6 2008,Paul B. '11,Woot!,http://mitadmissions.org/blogs/entry/woot,2044,0,0,0,0
Nov 5 2008,Daniel Barkowitz,Requirements,http://mitadmissions.org/blogs/entry/requirements,2045,0,0,0,0
Nov 4 2008,Chris S. '11,When Words Are Not Enough,http://mitadmissions.org/blogs/entry/when_words_are_not_enough,2046,0,0,0,0
Nov 4 2008,Chris M. '12,Tips from Me to You,http://mitadmissions.org/blogs/entry/tips_from_me_to_you,2046,0,0,0,0
Nov 4 2008,Kim Hunter '86,The InterviewPart IV,http://mitadmissions.org/blogs/entry/the_interviewpart_iv_1,2046,0,0,0,0
Nov 3 2008,Jess K. '10,"The Bad Week, or How To Lose Sleep and Alienate People",http://mitadmissions.org/blogs/entry/the_bad_week_or_how_to_lose_sl,2047,0,0,0,0
Nov 2 2008,Mikey Yang '05,Am I Smart Enough for MIT?,http://mitadmissions.org/blogs/entry/am_i_smart_enough_for_mit_1,2048,14,8,3,25
Nov 2 2008,Cristen C. '10,Ask Yourself,http://mitadmissions.org/blogs/entry/do_you_ltfp,2048,0,0,0,0
Nov 2 2008,Snively '11,Victorias Secret Update,http://mitadmissions.org/blogs/entry/victoria_secret_update,2048,0,0,0,0
Nov 1 2008,Snively '11,The Thong I Should Be Wearing [UPDATE],http://mitadmissions.org/blogs/entry/the_thong_i_should_be_wearing,2049,12,21,3,36
Nov 1 2008,Chris M. '12,Time Management,http://mitadmissions.org/blogs/entry/time_management,2049,0,2,0,2
Oct 31 2008,Paul B. '11,Hack or Treat,http://mitadmissions.org/blogs/entry/hack_or_treat,2050,0,0,0,0
Oct 31 2008,Daniel Barkowitz,"So much money, its scary",http://mitadmissions.org/blogs/entry/so_much_money_its_scary,2050,0,0,0,0
Oct 30 2008,Matt McGann '00,Early Action Season,http://mitadmissions.org/blogs/entry/early_action_season,2051,0,0,0,0
Oct 29 2008,Yan Z. '12,One year later,http://mitadmissions.org/blogs/entry/one_year_later,2052,0,0,0,0
Oct 29 2008,Snively '11,0 Days Since Last Fire Alarm,http://mitadmissions.org/blogs/entry/0_days_since_last_fire_alarm,2052,0,0,0,0
Oct 29 2008,ARTalk,A Look At Stagecraft,http://mitadmissions.org/blogs/entry/a_look_at_stagecraft,2052,0,0,0,0
Oct 28 2008,Ahmed H. '12,A Week of Music,http://mitadmissions.org/blogs/entry/a_week_of_music_1,2053,0,0,0,0
Oct 27 2008,Kim D. '09,And miles to go before I sleep.,http://mitadmissions.org/blogs/entry/and_miles_to_go_before_i_sleep,2054,0,0,0,0
Oct 27 2008,Keri G. '10,"Journal of Negative Results, among other things",http://mitadmissions.org/blogs/entry/journal_of_negative_results_among_other_things,2054,0,0,0,0
Oct 26 2008,Snively '11,Openness,http://mitadmissions.org/blogs/entry/openness,2055,0,0,0,0
Oct 25 2008,Snively '11,Banditos Misteriosos,http://mitadmissions.org/blogs/entry/banditos_misteriosos,2056,0,0,0,0
Oct 25 2008,Laura N. '09,Choose my Halloween Costume!,http://mitadmissions.org/blogs/entry/choose_my_halloween_costume,2056,0,0,0,0
Oct 24 2008,Paul B. '11,Whats on my mind,http://mitadmissions.org/blogs/entry/whats_on_my_mind,2057,0,0,0,0
Oct 24 2008,Chris S. '11,The Dark Side of the Moon,http://mitadmissions.org/blogs/entry/post_18,2057,0,0,0,0
Oct 23 2008,Lulu L. '09,"You win some, you lose some.",http://mitadmissions.org/blogs/entry/you_win_some_you_lose_some,2058,0,0,0,0
Oct 22 2008,Daniel Barkowitz,Its all about the money,http://mitadmissions.org/blogs/entry/its_all_about_the_money,2059,0,0,0,0
Oct 21 2008,Yan Z. '12,In pursuit of freedom,http://mitadmissions.org/blogs/entry/in_pursuit_of_freedom,2060,0,0,0,0
Oct 21 2008,Snively '11,Another fun problem,http://mitadmissions.org/blogs/entry/another_fun_problem,2060,0,0,0,0
Oct 21 2008,Ahmed H. '12,21L.011,http://mitadmissions.org/blogs/entry/21l011,2060,0,0,0,0
Oct 20 2008,Snively '11,Learning Time!,http://mitadmissions.org/blogs/entry/learning_time,2061,0,0,0,0
Oct 20 2008,Paul B. '11,One Week,http://mitadmissions.org/blogs/entry/one_week,2061,0,0,0,0
Oct 20 2008,Jess K. '10,Where WAS I?,http://mitadmissions.org/blogs/entry/where_was_i_1,2061,0,0,0,0
Oct 20 2008,Ahmed H. '12,Flame War,http://mitadmissions.org/blogs/entry/flame_war,2061,0,0,0,0
Oct 19 2008,ARTalk,The Imagination Box,http://mitadmissions.org/blogs/entry/the_imagination_box,2062,0,0,0,0
Oct 18 2008,Snively '11,MIT is hard,http://mitadmissions.org/blogs/entry/mit_is_hard,2063,2,0,1,3
Oct 17 2008,Ahmed H. '12,My Application Story,http://mitadmissions.org/blogs/entry/my_application_story,2064,5,1,5,11
Oct 17 2008,Mikey Yang '05,"So Long, So Long, Front Foot Leads the Back One",http://mitadmissions.org/blogs/entry/so_long_so_long_front_foot_lea,2064,0,0,0,0
Oct 16 2008,Yan Z. '12,Whats new and exciting?,http://mitadmissions.org/blogs/entry/whats_new_and_exciting,2065,0,0,0,0
Oct 15 2008,Shannon M. '12,The Global Poverty Initiative,http://mitadmissions.org/blogs/entry/the_global_poverty_initiative,2066,0,0,0,0
Oct 15 2008,Laura N. '09,Our nations greatest injustice,http://mitadmissions.org/blogs/entry/creative_title_here,2066,2,1,7,10
Oct 15 2008,Paul B. '11,Introduction to D-Lab,http://mitadmissions.org/blogs/entry/dlab,2066,0,0,0,0
Oct 14 2008,Yan Z. '12,Not my college essay,http://mitadmissions.org/blogs/entry/not_my_college_essay,2067,0,0,0,0
Oct 14 2008,Laura N. '09,Blog Action Day,http://mitadmissions.org/blogs/entry/blog_action_day,2067,0,0,0,0
Oct 14 2008,Lulu L. '09,Im the new 8.012 tutor!,http://mitadmissions.org/blogs/entry/im_the_new_8012_tutor,2067,0,0,0,0
Oct 13 2008,Ahmed H. '12,Everything You Ever Wanted to Know,http://mitadmissions.org/blogs/entry/everything_you_ever_wanted_to,2068,0,3,0,3
Oct 12 2008,Laura N. '09,MY college essay,http://mitadmissions.org/blogs/entry/my_college_essay_1,2069,1,0,0,1
Oct 11 2008,Cristen C. '10,My College Essay,http://mitadmissions.org/blogs/entry/my_college_essay,2070,9,8,1,18
Oct 10 2008,Cristen C. '10,My First Visit,http://mitadmissions.org/blogs/entry/my_first_visit,2071,0,0,0,0
Oct 10 2008,Laura N. '09,Island Paradise,http://mitadmissions.org/blogs/entry/island_paradise,2071,0,0,0,0
Oct 10 2008,Paul B. '11,Juggling Act,http://mitadmissions.org/blogs/entry/juggling_act,2071,0,0,0,0
Oct 10 2008,Lulu L. '09,Another take on pass/no-record,http://mitadmissions.org/blogs/entry/another_take_on_passnorecord,2071,4,0,0,4
Oct 9 2008,Yan Z. '12,Adventures in Chinatown,http://mitadmissions.org/blogs/entry/adventures_in_chinatown,2072,0,0,0,0
Oct 9 2008,Snively '11,Expanding on Pass No Record,http://mitadmissions.org/blogs/entry/expanding_on_pass_no_record,2072,0,2,3,5
Oct 9 2008,Kim Hunter '86,The InterviewPart 3,http://mitadmissions.org/blogs/entry/the_interviewpart_3,2072,0,0,0,0
Oct 9 2008,Laura N. '09,Flashback 1.0,http://mitadmissions.org/blogs/entry/flashback_10,2072,0,0,0,0
Oct 6 2008,Snively '11,What I just did,http://mitadmissions.org/blogs/entry/what_i_just_did,2075,0,0,0,0
Oct 4 2008,Ahmed H. '12,Seminar Advising,http://mitadmissions.org/blogs/entry/advisingmit,2077,0,0,0,0
Oct 4 2008,Chris M. '12,Internet Nostalgia,http://mitadmissions.org/blogs/entry/internet_nostalgia,2077,0,0,0,0
Oct 4 2008,ARTalk,Floating On A Whim,http://mitadmissions.org/blogs/entry/floating_on_a_whim,2077,0,0,0,0
Oct 4 2008,Yan Z. '12,Examining exams,http://mitadmissions.org/blogs/entry/examining_exams,2077,1,1,3,5
Oct 3 2008,Kim D. '09,VI-A,http://mitadmissions.org/blogs/entry/via_1,2078,0,0,0,0
Oct 3 2008,Daniel Barkowitz,The Human FactorKickoff of the Campaign For Students,http://mitadmissions.org/blogs/entry/the_human_factor_kickoff_of_th,2078,0,0,0,0
Oct 2 2008,Paul B. '11,50 Years of NASA,http://mitadmissions.org/blogs/entry/50_years_of_nasa,2079,0,0,0,0
Oct 1 2008,Quinton McArthur,"Food, Folks, and Fun..but definitely not mcdonalds",http://mitadmissions.org/blogs/entry/food_folks_and_funbut_definite,2080,0,0,0,0
Oct 1 2008,Daniel Barkowitz,You Are Welcome HereOut @ MIT,http://mitadmissions.org/blogs/entry/you_are_welcome_here_out_mit,2080,0,0,0,0
Oct 1 2008,ARTalk,Welcome To Guild Camp,http://mitadmissions.org/blogs/entry/welcome_to_guild_camp,2080,0,0,0,0
Sep 30 2008,Kim Hunter '86,The InterviewPart 2,http://mitadmissions.org/blogs/entry/the_interviewpart_2_1,2081,0,0,0,0
Sep 30 2008,Snively '11,E-mail,http://mitadmissions.org/blogs/entry/email,2081,1,8,2,11
Sep 29 2008,Lulu L. '09,Did you know about this?,http://mitadmissions.org/blogs/entry/did_you_know_about_this,2082,0,0,0,0
Sep 29 2008,Paul B. '11,Tunes of the All-Night Tool,http://mitadmissions.org/blogs/entry/tunes_of_the_allnight_tool,2082,0,0,0,0
Sep 28 2008,Cristen C. '10,Transporting In & Around MIT,http://mitadmissions.org/blogs/entry/transporting_in_around_mit_1,2083,0,0,0,0
Sep 28 2008,Kim Hunter '86,"California, Here I Come",http://mitadmissions.org/blogs/entry/california_here_i_come_1,2083,1,0,0,1
Sep 28 2008,Snively '11,Happy Birthday to m-suck.,http://mitadmissions.org/blogs/entry/happy_birthday_to_msuck,2083,0,0,0,0
Sep 28 2008,Ahmed H. '12,Grocery Store Run,http://mitadmissions.org/blogs/entry/grocery_store_run,2083,0,0,0,0
Sep 26 2008,Yan Z. '12,Sunday in the Park,http://mitadmissions.org/blogs/entry/sunday_in_the_park,2085,0,0,0,0
Sep 25 2008,Daniel Barkowitz,A Man and His Latte,http://mitadmissions.org/blogs/entry/a_man_and_his_latte,2086,0,0,0,0
Sep 25 2008,Chris S. '11,A Woman and Her Lute,http://mitadmissions.org/blogs/entry/a_woman_and_her_lute,2086,0,0,0,0
Sep 25 2008,Matt McGann '00,Avoid spelling errors!,http://mitadmissions.org/blogs/entry/avoid_spelling_errors,2086,0,0,0,0
Sep 25 2008,Snively '11,Dah noo-loo,http://mitadmissions.org/blogs/entry/dah_nooloo,2086,0,0,0,0
Sep 24 2008,Paul B. '11,Fall Formal,http://mitadmissions.org/blogs/entry/fall_formal,2087,0,0,0,0
Sep 24 2008,Daniel Barkowitz,"P-sets er, I mean Presets",http://mitadmissions.org/blogs/entry/psets_er_i_mean_presets_1,2087,0,0,0,0
Sep 24 2008,Kim D. '09,Alpha Phi Omega,http://mitadmissions.org/blogs/entry/alpha_phi_omega,2087,0,1,0,1
Sep 23 2008,Daniel Barkowitz,Re-search,http://mitadmissions.org/blogs/entry/research,2088,0,0,0,0
Sep 22 2008,Jess K. '10,Sick of Being Sick,http://mitadmissions.org/blogs/entry/sick_of_being_sick,2089,0,0,0,0
Sep 22 2008,Yan Z. '12,Fryday on Sunday,http://mitadmissions.org/blogs/entry/fryday_on_sunday,2089,0,0,0,0
Sep 22 2008,Mikey Yang '05,Im leavin on a jet plane,http://mitadmissions.org/blogs/entry/im_leavin_on_a_jet_plane,2089,0,0,0,0
Sep 18 2008,Cristen C. '10,A Week in the Life: Optimism Edition,http://mitadmissions.org/blogs/entry/post_16,2093,0,0,0,0
Sep 18 2008,Chris M. '12,"Sabar drums, Rwanda, and the C.I.A",http://mitadmissions.org/blogs/entry/sabar_drums_rwanda_and_the_cia,2093,0,0,0,0
Sep 18 2008,Kim Hunter '86,The InterviewPart 1,http://mitadmissions.org/blogs/entry/the_interviewpart_1,2093,0,0,0,0
Sep 17 2008,Chris M. '12,Tale of the Midnight Tool!,http://mitadmissions.org/blogs/entry/tale_of_the_midnight_tool_1,2094,0,0,0,0
Sep 17 2008,Kim D. '09,"Hi, (gasp!) Im Kim",http://mitadmissions.org/blogs/entry/hi_gasp_im_kim,2094,0,0,0,0
Sep 17 2008,Daniel Barkowitz,Happy constitution day,http://mitadmissions.org/blogs/entry/happy_constitution_day,2094,0,0,0,0
Sep 17 2008,Quinton McArthur,The Genesis,http://mitadmissions.org/blogs/entry/the_genesis,2094,0,0,0,0
Sep 17 2008,Shannon M. '12,Things that are hard.,http://mitadmissions.org/blogs/entry/things_that_are_hard_1,2094,0,0,0,0
Sep 16 2008,Yan Z. '12,A Day in the Life: Weekend Edition,http://mitadmissions.org/blogs/entry/a_day_in_the_life_weekend_edit,2095,0,0,0,0
Sep 15 2008,Snively '11,Colors!,http://mitadmissions.org/blogs/entry/colors,2096,0,0,0,0
Sep 15 2008,Laura N. '09,My Courses and Stuff,http://mitadmissions.org/blogs/entry/my_courses_and_stuff,2096,0,0,0,0
Sep 14 2008,Mikey Yang '05,And so it is,http://mitadmissions.org/blogs/entry/and_so_it_is_1,2097,0,0,0,0
Sep 13 2008,Keri G. '10,The leftmost station on your dial,http://mitadmissions.org/blogs/entry/the_leftmost_station_on_your_d,2098,0,0,0,0
Sep 13 2008,Ahmed H. '12,The Peanut Butter Delusion,http://mitadmissions.org/blogs/entry/the_peanut_butter_delusion,2098,0,0,0,0
Sep 12 2008,Snively '11,Got any threes?,http://mitadmissions.org/blogs/entry/got_any_threes,2099,0,1,0,1
Sep 11 2008,Yan Z. '12,"Tasty water, the Charles River, and other things that are not synonymous",http://mitadmissions.org/blogs/entry/tasty_water_the_charles_river,2100,1,0,0,1
Sep 11 2008,Kim Hunter '86,Replay,http://mitadmissions.org/blogs/entry/replay_1,2100,0,0,0,0
Sep 10 2008,Chris M. '12,LAST!,http://mitadmissions.org/blogs/entry/last,2101,0,0,0,0
Sep 9 2008,Matt McGann '00,Dorm Companion #1: Art,http://mitadmissions.org/blogs/entry/dorm_companion_1_art,2102,0,0,0,0
Sep 9 2008,Matt McGann '00,Dorm Companion #2: Cat,http://mitadmissions.org/blogs/entry/dorm_companion_2_cat,2102,7,13,20,40
Sep 6 2008,Laura N. '09,What I want to be when I grow up,http://mitadmissions.org/blogs/entry/what_i_want_to_be_when_i_grow,2105,0,0,0,0
Sep 6 2008,Chris S. '11,The Third Side of Fraternities,http://mitadmissions.org/blogs/entry/the_third_side_of_fraternities,2105,0,0,0,0
Sep 5 2008,Matt McGann '00,MIT goes on the road,http://mitadmissions.org/blogs/entry/mit_goes_on_the_road_1,2106,0,0,0,0
Sep 5 2008,Lulu L. '09,Fall term is already a nightmare,http://mitadmissions.org/blogs/entry/fall_term_is_already_a_nightma,2106,0,0,0,0
Sep 4 2008,Snively '11,The Other Side of Fraternities,http://mitadmissions.org/blogs/entry/the_other_side_of_fraternities,2107,0,0,0,0
Sep 4 2008,Matt McGann '00,The other 2 of the 3 Rs,http://mitadmissions.org/blogs/entry/the_other_2_of_the_3_rs,2107,0,0,0,0
Sep 4 2008,ROTC,Ops Air Force,http://mitadmissions.org/blogs/entry/ops_air_force_1,2107,0,0,0,0
Sep 4 2008,Jess K. '10,First Day of Class,http://mitadmissions.org/blogs/entry/first_day_of_classes_1,2107,0,0,0,0
Sep 4 2008,Chris S. '11,2008 Summer (Pics!),http://mitadmissions.org/blogs/entry/2008_summer_pics,2107,0,0,0,0
Sep 3 2008,Daniel Barkowitz,Hard Reboot,http://mitadmissions.org/blogs/entry/hard_reboot,2108,0,0,0,0
Sep 3 2008,Snively '11,Campus Activities,http://mitadmissions.org/blogs/entry/campus_activities,2108,0,0,0,0
Sep 2 2008,The Humanitarian Blog,My Last Blog: Introducing My Successor,http://mitadmissions.org/blogs/entry/my_last_blog_introducing_my_su,2109,0,0,0,0
Sep 2 2008,Lulu L. '09,"So, uh help me pick classes",http://mitadmissions.org/blogs/entry/so_uh_help_me_pick_classes,2109,0,0,0,0
Sep 2 2008,Matt McGann '00,Meet the Class of 2012,http://mitadmissions.org/blogs/entry/meet_the_class_of_2012,2109,0,1,0,1
Aug 31 2008,Jess K. '10,Love is Blinds,http://mitadmissions.org/blogs/entry/love_is_blind,2111,0,0,0,0
Aug 30 2008,Snively '11,Burton-Conner Floor Rush and Rooming,http://mitadmissions.org/blogs/entry/burtonconner_floor_rush_and_ro,2112,0,0,0,0
Aug 30 2008,Paul B. '11,Fraternities @ MIT,http://mitadmissions.org/blogs/entry/fraternities_mit,2112,2,1,5,8
Aug 29 2008,Snively '11,Surprise!,http://mitadmissions.org/blogs/entry/surprise,2113,0,0,0,0
Aug 29 2008,Jess K. '10,Summer Days,http://mitadmissions.org/blogs/entry/summer_days,2113,0,0,0,0
Aug 28 2008,Chris S. '11,"Advices, advices",http://mitadmissions.org/blogs/entry/advices_advices,2114,0,1,0,1
Aug 28 2008,Snively '11,"Copyright, Subpoenas, and You",http://mitadmissions.org/blogs/entry/copyright_subpoenas_and_you,2114,0,0,0,0
Aug 26 2008,Matt McGann '00,MIT Admissions Statistics 2008,http://mitadmissions.org/blogs/entry/mit_admissions_statistics_2008_1,2116,0,0,0,0
Aug 26 2008,Matt McGann '00,Blogger selection 2008 results,http://mitadmissions.org/blogs/entry/blogger_selection_2008_results_1,2116,0,0,0,0
Aug 25 2008,Snively '11,Why no blogs!?,http://mitadmissions.org/blogs/entry/why_no_blogs,2117,0,0,0,0
Aug 23 2008,Paul B. '11,If strangers meet life begins,http://mitadmissions.org/blogs/entry/if_strangers_meet_life_begins,2119,0,0,0,0
Aug 22 2008,Matt McGann '00,"MIT Olympians, Part 2",http://mitadmissions.org/blogs/entry/mit_olympians_part_2,2120,0,1,0,1
Aug 21 2008,Snively '11,Freebie,http://mitadmissions.org/blogs/entry/freebie,2121,0,0,0,0
Aug 21 2008,Laura N. '09,MIT Culture Shock,http://mitadmissions.org/blogs/entry/mit_culture_shock,2121,0,0,0,0
Aug 20 2008,Snively '11,Give Me Liberty . . .,http://mitadmissions.org/blogs/entry/give_me_liberty,2122,0,0,0,0
Aug 19 2008,Matt McGann '00,MIT Olympians,http://mitadmissions.org/blogs/entry/mit_olympians,2123,0,1,0,1
Aug 19 2008,Paul B. '11,Speaking in MITese,http://mitadmissions.org/blogs/entry/speaking_mitese,2123,0,1,0,1
Aug 17 2008,Lulu L. '09,Whats up?,http://mitadmissions.org/blogs/entry/heres_whats_going_on,2125,0,0,0,0
Aug 16 2008,Snively '11,The Mechanics of Blogging,http://mitadmissions.org/blogs/entry/the_mechanics_of_blogging,2126,0,0,0,0
Aug 16 2008,Laura N. '09,"Adios, Madrid",http://mitadmissions.org/blogs/entry/adios_madrid,2126,0,0,0,0
Aug 16 2008,Jess K. '10,Things Ive Missed About Home,http://mitadmissions.org/blogs/entry/things_ive_missed_about_home,2126,0,0,0,0
Aug 14 2008,Paul B. '11,MIT Medical: A Freshmans Story,http://mitadmissions.org/blogs/entry/mit_medical_a_freshmans_story,2128,0,0,0,0
Aug 14 2008,ARTalk,The New Show In Town,http://mitadmissions.org/blogs/entry/the_new_show_in_town,2128,0,0,0,0
Aug 13 2008,Snively '11,Lets Take a Walk,http://mitadmissions.org/blogs/entry/lets_take_a_walk,2129,0,0,0,0
Aug 12 2008,Jess K. '10,Central Square Dance Party,http://mitadmissions.org/blogs/entry/central_square_dance_party,2130,0,0,0,0
Aug 12 2008,Lulu L. '09,Two New Kittens,http://mitadmissions.org/blogs/entry/two_new_kittens,2130,0,0,0,0
Aug 9 2008,Paul B. '11,Summers End,http://mitadmissions.org/blogs/entry/summers_end,2133,0,0,0,0
Aug 7 2008,Snively '11,"Why yes, Im with the news",http://mitadmissions.org/blogs/entry/why_yes_im_with_the_news,2135,0,0,0,0
Aug 3 2008,Matt McGann '00,MIT Freshman Application: Live on Monday,http://mitadmissions.org/blogs/entry/mit_freshman_application_live,2139,0,0,0,0
Aug 3 2008,Paul B. '11,The Top of the World,http://mitadmissions.org/blogs/entry/the_top_of_the_world,2139,0,0,0,0
Aug 2 2008,Snively '11,Extra! Extra! Read All About It!,http://mitadmissions.org/blogs/entry/extra_extra_read_all_about_it,2140,0,0,0,0
Jul 31 2008,Laura N. '09,REX Sneak Peek,http://mitadmissions.org/blogs/entry/rex_sneak_peak,2142,0,0,0,0
Jul 30 2008,Matt McGann '00,Scholarship Opportunity: Davidson Fellows,http://mitadmissions.org/blogs/entry/scholarship_opportunity_davids,2143,0,1,0,1
Jul 30 2008,Paul B. '11,Questions about Blogging,http://mitadmissions.org/blogs/entry/questions_about_blogging,2143,0,0,0,0
Jul 28 2008,Snively '11,My MIT Story,http://mitadmissions.org/blogs/entry/my_mit_story_1,2145,0,1,0,1
Jul 28 2008,Lulu L. '09,What Im Watching,http://mitadmissions.org/blogs/entry/what_im_watching,2145,0,0,0,0
Jul 28 2008,Chris S. '11,Cest la Vie,http://mitadmissions.org/blogs/entry/cest_la_vie,2145,0,0,0,0
Jul 27 2008,Matt McGann '00,Selecting the new bloggers!,http://mitadmissions.org/blogs/entry/selecting_the_new_bloggers,2146,0,0,0,0
Jul 26 2008,Snively '11,Liveblog from Apple Store,http://mitadmissions.org/blogs/entry/liveblog_from_apple_store,2147,0,0,0,0
Jul 26 2008,Paul B. '11,Harvard Square Photoblog,http://mitadmissions.org/blogs/entry/harvard_square_photoblog,2147,0,0,0,0
Jul 25 2008,Laura N. '09,Wiimote Fun in Spain,http://mitadmissions.org/blogs/entry/wiimote_fun_in_spain,2148,0,0,0,0
Jul 25 2008,Keri G. '10,"Hello, Layover",http://mitadmissions.org/blogs/entry/hello_layover,2148,0,0,0,0
Jul 23 2008,Paul B. '11,The MIT Shakespeare Ensemble,http://mitadmissions.org/blogs/entry/the_mit_shakespeare_ensemble,2150,6,2,9,17
Jul 21 2008,Snively '11,Historic Boston,http://mitadmissions.org/blogs/entry/historic_boston,2152,0,0,0,0
Jul 21 2008,Matt McGann '00,Class of 2012 Profile Posted,http://mitadmissions.org/blogs/entry/class_of_2012_profile_posted,2152,0,0,0,0
Jul 18 2008,Paul B. '11,Bens Final Farewell,http://mitadmissions.org/blogs/entry/bens_final_farewell,2155,0,0,0,0
Jul 18 2008,Snively '11,Vespertilio,http://mitadmissions.org/blogs/entry/vespertilio,2155,0,0,0,0
Jul 18 2008,Chris S. '11,MIT Makes Taiwanese Talk Show!,http://mitadmissions.org/blogs/entry/mit_makes_taiwanese_talk_show,2155,0,0,0,0
Jul 14 2008,Snively '11,Hodge-Podge,http://mitadmissions.org/blogs/entry/hodgepodge,2159,0,0,0,0
Jul 12 2008,Keri G. '10,In which I am only slightly less boring than usual,http://mitadmissions.org/blogs/entry/in_which_i_am_only_slightly_le,2161,0,0,0,0
Jul 10 2008,Snively '11,Theme,http://mitadmissions.org/blogs/entry/theme,2163,0,0,0,0
Jul 10 2008,Jess K. '10,All-You-Can-Eat Summer,http://mitadmissions.org/blogs/entry/allyoucaneat_summer,2163,0,0,0,0
Jul 9 2008,Snively '11,NOOOOO!,http://mitadmissions.org/blogs/entry/nooooo,2164,0,0,0,0
Jul 9 2008,Laura N. '09,Culture Clash,http://mitadmissions.org/blogs/entry/culture_clash,2164,0,1,0,1
Jul 8 2008,Paul B. '11,In Their Own Words (Part 3),http://mitadmissions.org/blogs/entry/in_their_own_words_part_3,2165,0,0,0,0
Jul 7 2008,Matt McGann '00,The Pink Hair Problem,http://mitadmissions.org/blogs/entry/the_pink_hair_problem,2166,5,4,4,13
Jul 7 2008,Jess K. '10,Things That Are 20,http://mitadmissions.org/blogs/entry/things_that_are_20,2166,0,0,0,0
Jul 7 2008,Paul B. '11,Full Circle,http://mitadmissions.org/blogs/entry/full_circle,2166,0,0,0,0
Jul 6 2008,Chris S. '11,Remember the Fourth,http://mitadmissions.org/blogs/entry/remember_the_fourth,2167,0,0,0,0
Jul 5 2008,Lulu L. '09,Early Morning Construction,http://mitadmissions.org/blogs/entry/early_morning_construction,2168,0,0,0,0
Jul 5 2008,Laura N. '09,Es-pa-a!,http://mitadmissions.org/blogs/entry/espana,2168,0,0,0,0
Jul 4 2008,Snively '11,Bostons 3rd of July,http://mitadmissions.org/blogs/entry/bostons_3rd_of_july,2169,0,0,0,0
Jul 3 2008,Matt McGann '00,Bostons 4th of July,http://mitadmissions.org/blogs/entry/bostons_4th_of_july,2170,0,0,0,0
Jul 3 2008,Jess K. '10,Questions Omnibus 2,http://mitadmissions.org/blogs/entry/questions_omnibus_2,2170,0,0,0,0
Jul 1 2008,Matt McGann '00,MIT Meetings with Brown & Yale in Texas and Arizona,http://mitadmissions.org/blogs/entry/mit_meetings_with_brown_yale_i_1,2172,0,0,0,0
Jun 30 2008,Snively '11,Building 56,http://mitadmissions.org/blogs/entry/building_56,2173,0,0,0,0
Jun 30 2008,ARTalk,Legacy of a Media Storyteller,http://mitadmissions.org/blogs/entry/legacy_of_a_media_storyteller_1,2173,0,0,0,0
Jun 30 2008,Paul B. '11,In Their Own Words (Part 2),http://mitadmissions.org/blogs/entry/in_their_own_words_part_2,2173,0,0,0,0
Jun 29 2008,Snively '11,Run,http://mitadmissions.org/blogs/entry/run,2174,0,0,0,0
Jun 28 2008,Jess K. '10,Bens Farewell,http://mitadmissions.org/blogs/entry/bens_farewell,2175,0,0,0,0
Jun 27 2008,Snively '11,Summer,http://mitadmissions.org/blogs/entry/summer,2176,0,0,0,0
Jun 26 2008,Matt McGann '00,An Online Going-Away Card for Ben Jones,http://mitadmissions.org/blogs/entry/an_online_goingaway_card_for_b,2177,0,0,0,0
Jun 26 2008,Matt McGann '00,Best of the Ben Blogs,http://mitadmissions.org/blogs/entry/best_of_the_ben_blogs,2177,0,0,0,0
Jun 25 2008,Lulu L. '09,DEAPS 2005,http://mitadmissions.org/blogs/entry/deaps_2005,2178,0,0,0,0
Jun 24 2008,Matt McGann '00,Prof. Junot Diaz on The Colbert Report!,http://mitadmissions.org/blogs/entry/prof_junot_diaz_on_the_colbert,2179,1,0,0,1
Jun 24 2008,Snively '11,Ring Committee Wrap Up,http://mitadmissions.org/blogs/entry/ring_committee_wrap_up,2179,0,0,0,0
Jun 24 2008,Decisions,Waitlist Wrap-Up 2008,http://mitadmissions.org/blogs/entry/waitlist_wrapup_2008,2179,0,0,0,0
Jun 22 2008,Matt McGann '00,Alcohol in College: Scotland and the US,http://mitadmissions.org/blogs/entry/alcohol_in_college_scotland_an,2181,0,0,0,0
Jun 22 2008,Paul B. '11,In Their Own Words (Part 1),http://mitadmissions.org/blogs/entry/in_their_own_words_1,2181,0,0,0,0
Jun 21 2008,Snively '11,Win Sam Stuff!,http://mitadmissions.org/blogs/entry/dialup_um_no,2182,0,0,0,0
Jun 20 2008,Matt McGann '00,Transfer Wrap-Up 2008,http://mitadmissions.org/blogs/entry/transfer_wrapup_2008,2183,0,0,0,0
Jun 18 2008,Jess K. '10,The Class of 2010 Ring Delivery,http://mitadmissions.org/blogs/entry/the_class_of_2010_ring_deliver,2185,0,0,0,0
Jun 15 2008,Snively '11,Early Action versus Regular Action,http://mitadmissions.org/blogs/entry/early_action_versus_regular_ac,2188,4,14,0,18
Jun 14 2008,Laura N. '09,Happiness in threes,http://mitadmissions.org/blogs/entry/happiness_in_threes,2189,0,0,0,0
Jun 13 2008,Paul B. '11,Walk around the blogs,http://mitadmissions.org/blogs/entry/a_walk_around_the_blogs,2190,0,0,0,0
Jun 13 2008,Snively '11,Discovering Yourself,http://mitadmissions.org/blogs/entry/discovering_yourself_1,2190,0,0,0,0
Jun 13 2008,Daniel Barkowitz,"Hello, I must be going.",http://mitadmissions.org/blogs/entry/hello_i_must_be_going,2190,0,0,0,0
Jun 12 2008,Lulu L. '09,The fights begun but not yet won,http://mitadmissions.org/blogs/entry/the_fights_begun_but_not_yet_w,2191,0,0,0,0
Jun 11 2008,Snively '11,Cmo se dice?,http://mitadmissions.org/blogs/entry/como_se_dice,2192,0,0,0,0
Jun 11 2008,Melis A. '08,Beat the heat in the Z Center,http://mitadmissions.org/blogs/entry/beat_the_heat_in_the_z_center,2192,0,0,0,0
Jun 10 2008,Chris S. '11,Mini-Guide to the GIRs,http://mitadmissions.org/blogs/entry/miniguide_to_the_girs,2193,0,5,0,5
Jun 9 2008,Laura N. '09,I ,http://mitadmissions.org/blogs/entry/i_3_madrid,2194,0,0,0,0
Jun 7 2008,Snively '11,Hacking,http://mitadmissions.org/blogs/entry/hacking,2196,8,4,0,12
Jun 7 2008,Melis A. '08,"The end, my friend",http://mitadmissions.org/blogs/entry/the_end_my_friend,2196,0,0,0,0
Jun 6 2008,Lulu L. '09,Graduation,http://mitadmissions.org/blogs/entry/graduation,2197,0,0,0,0
Jun 4 2008,Snively '11,Read This!,http://mitadmissions.org/blogs/entry/read_this_1,2199,0,0,0,0
Jun 4 2008,Lulu L. '09,Summer & the Coming Commencement,http://mitadmissions.org/blogs/entry/summer_coming_commencement,2199,0,0,0,0
Jun 2 2008,Paul B. '11,The Scientist,http://mitadmissions.org/blogs/entry/the_scientist,2201,0,0,0,0
May 31 2008,Snively '11,Ring Committee,http://mitadmissions.org/blogs/entry/ring_committee_1,2203,0,1,0,1
May 31 2008,The Humanitarian Blog,Two Cool Projects,http://mitadmissions.org/blogs/entry/two_cool_projects,2203,0,0,0,0
May 31 2008,Melis A. '08,Prof. Jeff Karp and his gecko-inspired band-aid,http://mitadmissions.org/blogs/entry/prof_jeff_karp_and_his_geckoin_1,2203,1,2,1,4
May 30 2008,Karen F. '11,ICIC,http://mitadmissions.org/blogs/entry/icic,2204,0,0,0,0
May 29 2008,ARTalk,CRACKED,http://mitadmissions.org/blogs/entry/cracked,2205,0,0,0,0
May 28 2008,Jess K. '10,Ch-ch-ch-ch-changes,http://mitadmissions.org/blogs/entry/chchchchchanges,2206,0,0,0,0
May 27 2008,Snively '11,You have brains in your head.,http://mitadmissions.org/blogs/entry/you_have_brains_in_your_head,2207,0,0,0,0
May 27 2008,Chris S. '11,Oh the Places Youll Go!,http://mitadmissions.org/blogs/entry/oh_the_places_youll_go,2207,0,0,0,0
May 25 2008,Snively '11,Oh the People You See,http://mitadmissions.org/blogs/entry/oh_the_people_you_see,2209,0,0,0,0
May 25 2008,Melis A. '08,Noam Chomsky and the humanities at MIT,http://mitadmissions.org/blogs/entry/noam_chomsky_and_the_humanitie,2209,3,0,1,4
May 24 2008,Karen F. '11,Neil Gaiman!,http://mitadmissions.org/blogs/entry/neil_gaiman,2210,0,0,0,0
May 23 2008,Snively '11,Diffusion,http://mitadmissions.org/blogs/entry/post_17,2211,0,0,0,0
May 23 2008,Paul B. '11,Neil Gaiman: The Liveblog,http://mitadmissions.org/blogs/entry/neil_gaiman_the_liveblog,2211,0,0,0,0
May 22 2008,Paul B. '11,"Moving On, Moving Out, and the Conservation of Freshmen",http://mitadmissions.org/blogs/entry/moving_on_moving_out,2212,3,5,1,9
May 21 2008,The Humanitarian Blog,P.S.Check out the Booklet!,http://mitadmissions.org/blogs/entry/ps_check_out_the_booklet,2213,0,0,0,0
May 21 2008,The Humanitarian Blog,The One and Only Melis,http://mitadmissions.org/blogs/entry/the_one_and_only_melis,2213,1,1,0,2
May 21 2008,Snively '11,Study Break,http://mitadmissions.org/blogs/entry/study_break_1,2213,0,0,0,0
May 20 2008,Decisions,Waitlist Update,http://mitadmissions.org/blogs/entry/waitlist_update,2214,0,0,0,0
May 20 2008,Karen F. '11,Eleven,http://mitadmissions.org/blogs/entry/eleven_1,2214,0,0,0,0
May 19 2008,Laura N. '09,Post-finals stress?,http://mitadmissions.org/blogs/entry/postfinals_stress,2215,0,0,0,0
May 19 2008,Paul B. '11,A Look Ahead,http://mitadmissions.org/blogs/entry/a_look_ahead,2215,0,0,0,0
May 17 2008,Snively '11,Studying For Finals,http://mitadmissions.org/blogs/entry/studying_for_finals,2217,0,0,0,0
May 16 2008,Daniel Barkowitz,Advising Blow OutPF Finale Blue,http://mitadmissions.org/blogs/entry/advising_blow_out_pf_finale_bl,2218,0,0,0,0
May 16 2008,Chris S. '11,Seasons of Spam,http://mitadmissions.org/blogs/entry/seasons_of_spam,2218,0,0,0,0
May 16 2008,ARTalk,Alpha Delta Phi Presents  Mic-Check,http://mitadmissions.org/blogs/entry/alpha_delta_phi_presents_micch,2218,0,0,0,0
May 16 2008,Snively '11,Toy Design Wrapup,http://mitadmissions.org/blogs/entry/toy_design_wrapup,2218,0,0,0,0
May 15 2008,Laura N. '09,The Internet is Weird,http://mitadmissions.org/blogs/entry/the_internet_is_weird,2219,0,1,0,1
May 15 2008,Ben Jones,Big News,http://mitadmissions.org/blogs/entry/big_news,2219,0,0,0,0
May 14 2008,Jess K. '10,Boston Marathon 08,http://mitadmissions.org/blogs/entry/boston_marathon_08,2220,0,0,0,0
May 13 2008,Lulu L. '09,Disaster Relief,http://mitadmissions.org/blogs/entry/disaster_relief,2221,0,0,0,0
May 13 2008,Cambridge,A Day in the Life (3)... [Biochemistry],http://mitadmissions.org/blogs/entry/a_day_in_the_life_3_biochemist,2221,0,0,0,0
May 12 2008,Matt McGann '00,Waitlist News,http://mitadmissions.org/blogs/entry/waitlist_news,2222,0,0,0,0
May 12 2008,Melis A. '08,"Cake-offs, chariot races, and salsa dancing",http://mitadmissions.org/blogs/entry/cakeoffs_chariot_races_and_sal_1,2222,0,0,0,0
May 12 2008,ARTalk,How Do You Mic A Stripper?,http://mitadmissions.org/blogs/entry/how_do_you_mic_a_stripper,2222,0,0,0,0
May 11 2008,Chris S. '11,WTHBBQ! Chinese Buffet!,http://mitadmissions.org/blogs/entry/wthbbq_chinese_buffet,2223,0,0,0,0
May 11 2008,Snively '11,Late Night,http://mitadmissions.org/blogs/entry/late_night,2223,0,0,0,0
May 10 2008,The Humanitarian Blog,"Updates, Previews, and My Successor",http://mitadmissions.org/blogs/entry/updates_previews_and_my_succes,2224,0,0,0,0
May 10 2008,Paul B. '11,When Friday Arrives,http://mitadmissions.org/blogs/entry/when_friday_arrives,2224,0,0,0,0
May 9 2008,Snively '11,DONE (sorta),http://mitadmissions.org/blogs/entry/done_sorta,2225,0,0,0,0
May 8 2008,Cambridge,Life and Learning in the Other Cambridge,http://mitadmissions.org/blogs/entry/life_and_learning_in_the_other,2226,0,0,0,0
May 8 2008,Chris S. '11,"It Ends Tonight, It Ends Tonight",http://mitadmissions.org/blogs/entry/it_ends_tonight_it_ends_tonigh,2226,0,0,0,0
May 7 2008,Derrick B. '08,My UROP Experiences,http://mitadmissions.org/blogs/entry/my_urop_experiences_1,2227,0,0,0,0
May 7 2008,Lulu L. '09,"Whatever, this week rocks",http://mitadmissions.org/blogs/entry/whatever_this_week_rocks,2227,0,0,0,0
May 6 2008,Snively '11,When it Rains,http://mitadmissions.org/blogs/entry/when_it_rains,2228,0,0,0,0
May 6 2008,ARTalk,Mens et Manus: Building a Camera at the Hobby Shop,http://mitadmissions.org/blogs/entry/mens_et_manus_building_a_camer_1,2228,0,0,0,0
May 5 2008,Keri G. '10,Steer Roast 2008,http://mitadmissions.org/blogs/entry/steer_roast_2008,2229,0,0,0,0
May 4 2008,Snively '11,"And Im leaving, on a . . . cruise ship?",http://mitadmissions.org/blogs/entry/and_im_leaving_on_a_cruise_shi,2230,0,0,0,0
May 4 2008,Matt McGann '00,"Iron Man, MIT 87 (?)",http://mitadmissions.org/blogs/entry/iron_man_mit_87,2230,116,67,30,213
May 4 2008,Melis A. '08,Senior Ball 2008,http://mitadmissions.org/blogs/entry/senior_ball_2008,2230,0,0,0,0
May 4 2008,Cambridge,A Day in the Life (2)... [Mathematics],http://mitadmissions.org/blogs/entry/a_day_in_the_life_2,2230,0,0,0,0
May 2 2008,Snively '11,ROFLCON!,http://mitadmissions.org/blogs/entry/roflcon,2232,0,0,0,0
May 2 2008,ARTalk,LSC: A Brief Summary,http://mitadmissions.org/blogs/entry/lsc_a_brief_summary,2232,0,0,0,0
May 1 2008,Daniel Barkowitz,Minty E. Coli,http://mitadmissions.org/blogs/entry/minty_e_coli,2233,0,0,0,0
May 1 2008,Cambridge,A Day in the Life [Biochemistry],http://mitadmissions.org/blogs/entry/post_15,2233,0,0,0,0
May 1 2008,Daniel Barkowitz,FASU 9 - Coming up for a breath of fresh air!,http://mitadmissions.org/blogs/entry/fasu_9_coming_up_for_a_breath,2233,0,0,0,0
May 1 2008,Chris S. '11,Happy May!,http://mitadmissions.org/blogs/entry/happy_may,2233,0,0,0,0
Apr 30 2008,Matt McGann '00,Decision Day Eve,http://mitadmissions.org/blogs/entry/decision_day_eve,2234,0,0,0,0
Apr 29 2008,Paul B. '11,Takin My Time,http://mitadmissions.org/blogs/entry/takin_my_time,2235,0,0,0,0
Apr 27 2008,Cambridge,Cream Tea with the MIT Club of Great Britain,http://mitadmissions.org/blogs/entry/cream_tea_with_the_mit_club_of,2237,0,0,0,0
Apr 27 2008,Snively '11,Lip Sync 08,http://mitadmissions.org/blogs/entry/lip_sync_08,2237,0,0,0,0
Apr 26 2008,Paul B. '11,The Road Im On,http://mitadmissions.org/blogs/entry/the_road_im_on,2238,0,0,0,0
Apr 26 2008,Cambridge,St. Georges Day,http://mitadmissions.org/blogs/entry/st_georges_day,2238,0,0,0,0
Apr 26 2008,Chris S. '11,INT to the INT to the IN(s)T,http://mitadmissions.org/blogs/entry/int_to_the_int_to_the_inst,2238,0,0,0,0
Apr 25 2008,ARTalk,Music in Springtime and MIT,http://mitadmissions.org/blogs/entry/music_in_springtime_and_mit,2239,0,0,0,0
Apr 24 2008,mitblogs,Adventures of a Prefrosh: My Year On,http://mitadmissions.org/blogs/entry/adventures_of_a_prefrosh_my_ye,2240,0,0,0,0
Apr 24 2008,ROTC,CHICON 2008,http://mitadmissions.org/blogs/entry/chicon_2008,2240,0,1,0,1
Apr 24 2008,Melis A. '08,Paris Hilton comes to MIT,http://mitadmissions.org/blogs/entry/paris_hilton_comes_to_mit,2240,0,0,0,0
Apr 23 2008,Evan B. '10,Live Kernel Patching System,http://mitadmissions.org/blogs/entry/live_kernel_patching_system,2241,0,0,0,0
Apr 23 2008,Matt McGann '00,The MIT Spring Concert,http://mitadmissions.org/blogs/entry/the_mit_spring_concert,2241,0,1,1,2
Apr 22 2008,Paul B. '11,Like Burger King - Only Not (Guest Entry),http://mitadmissions.org/blogs/entry/like_burger_king,2242,0,0,0,0
Apr 22 2008,Snively '11,Of Dancing and T-Shirts (Guest Entry),http://mitadmissions.org/blogs/entry/post_14,2242,0,0,0,0
Apr 22 2008,Paul B. '11,CPW-ing the Weekend (Guest Entry),http://mitadmissions.org/blogs/entry/cpwing_the_weekend,2242,0,0,0,0
Apr 21 2008,Bryan O. '09,A Parents Perspective (Guest Entry),http://mitadmissions.org/blogs/entry/a_parents_perspective_guest_en,2243,0,0,0,0
Apr 21 2008,Bryan O. '09,"Short, Sweet, and to the Point: MIT in five senses or less (Guest Entry)",http://mitadmissions.org/blogs/entry/short_sweet_and_to_the_point_m,2243,0,0,0,0
Apr 21 2008,Snively '11,*witty title here* (Guest Entry),http://mitadmissions.org/blogs/entry/witty_title_here_guest_entry,2243,0,0,0,0
Apr 21 2008,Matt McGann '00,"MIT Meetings with Brown & Yale in CA, IL, MI, NV, OH",http://mitadmissions.org/blogs/entry/mit_meetings_with_brown_yale_i,2243,0,0,0,0
Apr 20 2008,Snively '11,Blending In (Guest Entry),http://mitadmissions.org/blogs/entry/post_13,2244,0,0,0,0
Apr 20 2008,Paul B. '11,Finding My Way Around MIT (Guest Entry),http://mitadmissions.org/blogs/entry/finding_my_way_around_mit_gues,2244,0,0,0,0
Apr 20 2008,Bryan O. '09,Take Me Back to Tech (Guest Entry),http://mitadmissions.org/blogs/entry/take_me_back_to_tech_guest_ent,2244,0,0,0,0
Apr 20 2008,Snively '11,CPW 2008: So I think Ill go to Boston (Guest Entry),http://mitadmissions.org/blogs/entry/cpw_2008_so_i_think_ill_go_to,2244,0,0,0,0
Apr 19 2008,Paul B. '11,CPW 2008 - Another Highly Satisfied Customer! (Guest Entry),http://mitadmissions.org/blogs/entry/cpw_2008_-_another_highly_satisfied_customer,2245,0,0,0,0
Apr 19 2008,Bryan O. '09,CPW Recap (Guest Entry),http://mitadmissions.org/blogs/entry/cpw_recap_guest_entry,2245,0,0,0,0
Apr 18 2008,Karen F. '11,Happy Things,http://mitadmissions.org/blogs/entry/happy_things,2246,0,0,0,0
Apr 18 2008,Snively '11,Celena in CPW-Land (Guest Entry),http://mitadmissions.org/blogs/entry/celena_in_cpwland_guest_entry,2246,0,0,0,0
Apr 18 2008,Paul B. '11,I Think Ive Found Paradise (Guest Entry),http://mitadmissions.org/blogs/entry/i_think_ive_found_paradise,2246,0,0,0,0
Apr 18 2008,Snively '11,"What can I say, it grew on me . . . (Guest Entry)",http://mitadmissions.org/blogs/entry/what_can_i_say_it_grew_on_me,2246,0,0,0,0
Apr 18 2008,Chris S. '11,Mastering Physics Has No Soul,http://mitadmissions.org/blogs/entry/mastering_physics_has_no_soul,2246,0,0,0,0
Apr 17 2008,Bryan O. '09,The First Four Days of the Next Four Years (Guest Entry),http://mitadmissions.org/blogs/entry/the_first_four_days_of_the_nex,2247,0,0,0,0
Apr 17 2008,Snively '11,CPW 2008 @ MIT - Awesomeness Guaranteed (Guest Entry),http://mitadmissions.org/blogs/entry/cpw_2008_mit_awesomeness_guara,2247,0,0,0,0
Apr 17 2008,Snively '11,Toy Design Update,http://mitadmissions.org/blogs/entry/toy_design_update,2247,0,0,0,0
Apr 16 2008,Paul B. '11,Lament for CPW (Guest Entry),http://mitadmissions.org/blogs/entry/lament_for_cpw,2248,0,0,0,0
Apr 16 2008,Matt McGann '00,"CPW, via Video",http://mitadmissions.org/blogs/entry/cpw_via_video,2248,0,0,0,0
Apr 14 2008,Lulu L. '09,Sore Subjects,http://mitadmissions.org/blogs/entry/sore_subjects,2250,0,0,0,0
Apr 14 2008,Ben Jones,MTB Party Pic & TechTV CPW Coverage,http://mitadmissions.org/blogs/entry/mtb_party_pic_techtv_cpw_cover,2250,0,0,0,0
Apr 13 2008,Chris S. '11,72 Hours Later,http://mitadmissions.org/blogs/entry/72_hours_later,2251,0,0,0,0
Apr 13 2008,Snively '11,The State of Things,http://mitadmissions.org/blogs/entry/the_state_of_things,2251,0,0,0,0
Apr 12 2008,Snively '11,Susan Hockfields Private Concert,http://mitadmissions.org/blogs/entry/susan_hockfields_private_conce,2252,0,0,0,0
Apr 10 2008,Daniel Barkowitz,CPW Presentation - Friday 1:00 pm,http://mitadmissions.org/blogs/entry/cpw_presentation_friday_100_pm,2254,0,0,0,0
Apr 10 2008,Paul B. '11,CPW: The Story So Far,http://mitadmissions.org/blogs/entry/cpw_the_story_so_far,2254,0,0,0,0
Apr 10 2008,Snively '11,CPW 2008: The Hack Edition,http://mitadmissions.org/blogs/entry/cpw_2008_the_hack_edition,2254,0,1,0,1
Apr 10 2008,Ben Jones,CPW LiveBlogging Project Followup,http://mitadmissions.org/blogs/entry/cpw_liveblogging_project_follo,2254,0,0,0,0
Apr 10 2008,Matt McGann '00,Whats Going On,http://mitadmissions.org/blogs/entry/whats_going_on,2254,0,0,0,0
Apr 9 2008,Snively '11,"How hard is it, really?",http://mitadmissions.org/blogs/entry/how_hard_is_it_really,2255,3,2,2,7
Apr 8 2008,Matt McGann '00,A CPW Entry for Parents,http://mitadmissions.org/blogs/entry/a_cpw_entry_for_parents,2256,0,0,0,0
Apr 8 2008,Snively '11,Oh Wow,http://mitadmissions.org/blogs/entry/oh_wow,2256,0,0,0,0
Apr 7 2008,Daniel Barkowitz,FASU 8: Fridays Updatejust a little late (and Q&As),http://mitadmissions.org/blogs/entry/fasu_8_fridays_update_just_a_l_1,2257,0,0,0,0
Apr 6 2008,Matt McGann '00,What to expect when youre expecting CPW,http://mitadmissions.org/blogs/entry/what_to_expect_when_youre_expe,2258,0,1,0,1
Apr 6 2008,Jess K. '10,Burton 1 Cribs,http://mitadmissions.org/blogs/entry/burton_1_cribs,2258,0,0,0,0
Apr 5 2008,Paul B. '11,Hitchhikers Guide to CPW,http://mitadmissions.org/blogs/entry/hitchhikers_guide_to_cpw,2259,0,0,0,0
Apr 5 2008,Bryan O. '09,Surviving CPW,http://mitadmissions.org/blogs/entry/surviving_cpw,2259,0,0,0,0
Apr 5 2008,Snively '11,Im Poor!!!,http://mitadmissions.org/blogs/entry/im_poor,2259,1,0,0,1
Apr 4 2008,Karen F. '11,Interphase,http://mitadmissions.org/blogs/entry/interphase,2260,0,1,0,1
Apr 4 2008,Matt McGann '00,On taking a Gap Year,http://mitadmissions.org/blogs/entry/on_taking_a_gap_year,2260,0,1,0,1
Apr 4 2008,mitblogs,Leadership Training Institute,http://mitadmissions.org/blogs/entry/leadership_training_institute,2260,0,0,0,0
Apr 3 2008,Ben Jones,The CPW LiveBlogging Project,http://mitadmissions.org/blogs/entry/the_cpw_liveblogging_project,2261,0,0,0,0
Apr 2 2008,Melis A. '08,One of those big picture days,http://mitadmissions.org/blogs/entry/one_of_those_big_picture_days,2262,0,0,0,0
Apr 2 2008,Keri G. '10,Gluten-free at MIT,http://mitadmissions.org/blogs/entry/glutenfree_at_mit,2262,0,1,0,1
Apr 2 2008,ARTalk,Take 1.618: Film at MIT,http://mitadmissions.org/blogs/entry/take_1618_film_at_mit,2262,0,0,0,0
Apr 1 2008,Daniel Barkowitz,REPOST: Singing in Four Part HarmonyOr What Makes up your EFC,http://mitadmissions.org/blogs/entry/repost_singing_in_four_part_ha,2263,0,0,0,0
Apr 1 2008,Daniel Barkowitz,FASU 7 - Current status and future plans,http://mitadmissions.org/blogs/entry/fasu_7_current_status_and_futu,2263,0,0,0,0
Apr 1 2008,Bryan O. '09,A Fools Holiday,http://mitadmissions.org/blogs/entry/how_mit_celebrates_41,2263,0,0,0,0
Apr 1 2008,Bryan O. '09,Your Name in Flashing Lights,http://mitadmissions.org/blogs/entry/your_name_in_flashing_lights,2263,0,0,0,0
Apr 1 2008,Snively '11,Rrrrrrr. CPW! [UPDATE],http://mitadmissions.org/blogs/entry/rrrrrrr_cpw,2263,0,0,0,0
Mar 31 2008,Matt McGann '00,21: The Movie Night,http://mitadmissions.org/blogs/entry/21_the_movie_night,2264,0,0,0,0
Mar 31 2008,Ben Jones,CPW Registration - Important!,http://mitadmissions.org/blogs/entry/cpw_registration_important,2264,0,0,0,0
Mar 31 2008,Bryan O. '09,From the eyes of a newly minted EC,http://mitadmissions.org/blogs/entry/from_the_eyes_of_a_newly_minte,2264,0,0,0,0
Mar 30 2008,Jess K. '10,Meeting Michel Gondry,http://mitadmissions.org/blogs/entry/meeting_michel_gondry,2265,0,0,0,0
Mar 30 2008,Chris S. '11,21: The Movie,http://mitadmissions.org/blogs/entry/21_the_movie,2265,0,0,0,0
Mar 29 2008,Snively '11,Strike! Strike! Strike!,http://mitadmissions.org/blogs/entry/strike_strike_strike,2266,0,0,0,0
Mar 29 2008,Paul B. '11,61 Things to Love About Boston,http://mitadmissions.org/blogs/entry/61_things_to_love_about_boston,2266,0,0,0,0
Mar 28 2008,ARTalk,"Acting, Writing, and Roleplaying: A Match Made in Heaven",http://mitadmissions.org/blogs/entry/acting_writing_and_roleplaying,2267,0,0,0,0
Mar 28 2008,Snively '11,MIT Info Session,http://mitadmissions.org/blogs/entry/mit_info_session,2267,0,0,0,0
Mar 28 2008,Daniel Barkowitz,LiveBlogging Bens Info Session,http://mitadmissions.org/blogs/entry/liveblogging_bens_info_session,2267,0,0,0,0
Mar 28 2008,Stu Schmill '86,Reflections,http://mitadmissions.org/blogs/entry/reflections,2267,1,0,0,1
Mar 27 2008,Daniel Barkowitz,"FASU6 - More Awards in the Mail, and CPW overview",http://mitadmissions.org/blogs/entry/fasu6_more_awards_in_the_mail,2268,0,0,0,0
Mar 27 2008,Melis A. '08,10 things I love about MIT,http://mitadmissions.org/blogs/entry/10_things_i_love_about_mit_1,2268,5,5,0,10
Mar 26 2008,Daniel Barkowitz,FASU 5 - Pie Charts and Student Aid Profiles,http://mitadmissions.org/blogs/entry/fasu_5_-_pie_charts_and_student_aid_profiles,2269,0,0,0,0
Mar 26 2008,Snively '11,Your MIT ID,http://mitadmissions.org/blogs/entry/your_mit_id,2269,0,0,0,0
Mar 26 2008,Ben Jones,Updates And Shannons Formula,http://mitadmissions.org/blogs/entry/updates_and_shannons_formula,2269,0,0,0,0
Mar 26 2008,Daniel Barkowitz,fine-ann-shul ade lol cat,http://mitadmissions.org/blogs/entry/0fineannshul_ade_lol_cat,2269,0,0,0,0
Mar 26 2008,Matt McGann '00,Class of 2012 Night at the Movies,http://mitadmissions.org/blogs/entry/class_of_2012_night_at_the_mov,2269,0,0,0,0
Mar 25 2008,Daniel Barkowitz,FASU 4 - Trying to Push Snively Off the Front Page,http://mitadmissions.org/blogs/entry/fasu_4_trying_to_push_snively,2270,0,0,0,0
Mar 25 2008,Paul B. '11,All these days I spend away,http://mitadmissions.org/blogs/entry/all_these_days_i_spend_away,2270,0,0,0,0
Mar 25 2008,Daniel Barkowitz,Dans / Dans Evolution,http://mitadmissions.org/blogs/entry/dans_dans_evolution,2270,0,0,0,0
Mar 24 2008,Matt McGann '00,Stu Schmill 86 named Dean of Admissions,http://mitadmissions.org/blogs/entry/stu_schmill_86_named_dean_of_a,2271,0,1,7,8
Mar 24 2008,Daniel Barkowitz,We are need-blind for all our populations,http://mitadmissions.org/blogs/entry/we_are_needblind_for_all_our_p,2271,0,0,0,0
Mar 24 2008,Snively '11,AND THERE WAS A PILLOW FIGHT!!!,http://mitadmissions.org/blogs/entry/and_there_was_a_pillow_fight,2271,0,0,0,0
Mar 23 2008,ARTalk,Upside-down and Reversed: Photography at MIT,http://mitadmissions.org/blogs/entry/upsidedown_and_reversed_photog_1,2272,0,0,0,0
Mar 22 2008,Snively '11,Laptops!,http://mitadmissions.org/blogs/entry/laptops,2273,1,3,0,4
Mar 21 2008,Karen F. '11,On Latin American Things,http://mitadmissions.org/blogs/entry/on_latin_american_things,2274,0,0,0,0
Mar 21 2008,Daniel Barkowitz,FASU3 - More news and information,http://mitadmissions.org/blogs/entry/fasu3_more_news_and_informatio,2274,0,0,0,0
Mar 21 2008,Chris S. '11,A Mystery Hunt Puzzle,http://mitadmissions.org/blogs/entry/a_mystery_hunt_puzzle,2274,0,0,0,0
Mar 20 2008,Laura N. '09,Forget that,http://mitadmissions.org/blogs/entry/forget_that,2275,0,0,0,0
Mar 20 2008,Daniel Barkowitz,Real Financial Heroes,http://mitadmissions.org/blogs/entry/real_financial_heroes,2275,0,0,0,0
Mar 20 2008,Matt McGann '00,Updates for the Admitted,http://mitadmissions.org/blogs/entry/updates_for_the_admitted,2275,0,0,0,0
Mar 20 2008,Matt McGann '00,Q&A for the Waitlisted,http://mitadmissions.org/blogs/entry/qa_for_the_waitlisted,2275,0,0,0,0
Mar 19 2008,Derrick B. '08,Dont Neglect Your Creative Side,http://mitadmissions.org/blogs/entry/dont_neglect_your_creative_sid_1,2276,0,0,0,0
Mar 19 2008,Snively '11,Tour/Hack/Math,http://mitadmissions.org/blogs/entry/tourhackmath,2276,1,1,1,3
Mar 19 2008,mitblogs,What Do You DO All Day?,http://mitadmissions.org/blogs/entry/what_do_you_do_all_day,2276,0,0,0,0
Mar 19 2008,Daniel Barkowitz,"FASU2(3D) - Decisions, Dilemmas and Documents",http://mitadmissions.org/blogs/entry/fasu23d,2276,0,0,0,0
Mar 19 2008,Paul B. '11,The Firehose,http://mitadmissions.org/blogs/entry/the_firehose,2276,0,2,0,2
Mar 19 2008,Lulu L. '09,Poems,http://mitadmissions.org/blogs/entry/poems,2276,0,0,0,0
Mar 18 2008,ARTalk,Making Time For Art,http://mitadmissions.org/blogs/entry/making_time_for_art,2277,0,0,0,0
Mar 18 2008,Jess K. '10,Pi(e) Day,http://mitadmissions.org/blogs/entry/pi_day_again,2277,0,0,0,0
Mar 18 2008,Paul B. '11,"Welcome to MIT, Class of 2012",http://mitadmissions.org/blogs/entry/welcome_to_mit,2277,0,0,0,0
Mar 17 2008,Matt McGann '00,Snapshot Statshot,http://mitadmissions.org/blogs/entry/snapshot_statshot,2278,0,2,0,2
Mar 17 2008,Snively '11,Pie,http://mitadmissions.org/blogs/entry/pie,2278,0,0,0,0
Mar 17 2008,Daniel Barkowitz,Financial Aid Status Update (FASU) #1,http://mitadmissions.org/blogs/entry/financial_aid_status_update_fa_1,2278,0,0,0,0
Mar 17 2008,Evan B. '10,The Zone Cell Challenge,http://mitadmissions.org/blogs/entry/the_zone_cell_challenge,2278,0,0,0,0
Mar 17 2008,Paul B. '11,After the Storm,http://mitadmissions.org/blogs/entry/after_the_storm,2278,0,0,0,0
Mar 15 2008,Decisions,Admitted,http://mitadmissions.org/blogs/entry/admitted_4,2280,0,0,0,0
Mar 15 2008,Decisions,Waitlisted,http://mitadmissions.org/blogs/entry/waitlisted_2,2280,0,0,0,0
Mar 15 2008,Decisions,Not Admitted,http://mitadmissions.org/blogs/entry/not_admitted_3,2280,0,0,0,0
Mar 15 2008,Ben Jones,Eye Of The Storm,http://mitadmissions.org/blogs/entry/eye_of_the_storm,2280,0,0,0,0
Mar 15 2008,Snively '11,Hey Guess What Guys!,http://mitadmissions.org/blogs/entry/hey_guess_what_guys,2280,0,0,0,0
Mar 14 2008,Paul B. '11,"One for sorrow, two for joy",http://mitadmissions.org/blogs/entry/one_for_sorrow_two_for_joy,2281,0,0,0,0
Mar 14 2008,Daniel Barkowitz,How MIT and the Freshmen Admissions Process Helps Me See Clearly,http://mitadmissions.org/blogs/entry/how_mit_and_the_freshmen_admis,2281,0,0,0,0
Mar 14 2008,Karen F. '11,Bread at Desk,http://mitadmissions.org/blogs/entry/bread_at_desk,2281,0,0,0,0
Mar 14 2008,Snively '11,"Outside of a dog, a book is mans best friend.",http://mitadmissions.org/blogs/entry/outside_of_a_dog_a_book_is_man,2281,0,0,0,0
Mar 14 2008,Daniel Barkowitz, Day,http://mitadmissions.org/blogs/entry/day_1,2281,0,0,0,0
Mar 13 2008,Laura N. '09,Why I havent posted in forever,http://mitadmissions.org/blogs/entry/why_i_havent_posted_in_forever,2282,0,0,0,0
Mar 13 2008,Keri G. '10,Things to do while waiting for decisions on Saturday,http://mitadmissions.org/blogs/entry/things_to_do_while_waiting_for_2,2282,0,1,0,1
Mar 12 2008,Paul B. '11,A Brief Taste of Orgo,http://mitadmissions.org/blogs/entry/a_brief_taste_of_orgo,2283,0,0,0,0
Mar 12 2008,Daniel Barkowitz,Letter Writing (or how 3 = 15 = 1),http://mitadmissions.org/blogs/entry/letter_writing_or_how_3_15_1,2283,0,0,0,0
Mar 11 2008,Snively '11,Product Design Lab,http://mitadmissions.org/blogs/entry/product_design,2284,0,0,0,0
Mar 11 2008,Daniel Barkowitz,Armchair Traveling,http://mitadmissions.org/blogs/entry/armchair_traveling,2284,0,0,0,0
Mar 10 2008,Derrick B. '08,Whew!,http://mitadmissions.org/blogs/entry/whew_1,2285,0,0,0,0
Mar 9 2008,Cambridge,Crotchets and Quavers,http://mitadmissions.org/blogs/entry/crotchets_and_quavers,2286,0,0,0,0
Mar 9 2008,Chris S. '11,H0sed,http://mitadmissions.org/blogs/entry/h0sed,2286,0,0,0,0
Mar 9 2008,Snively '11,Devoid of Content,http://mitadmissions.org/blogs/entry/devoid_of_content_1,2286,0,0,0,0
Mar 9 2008,Jess K. '10,The Sam Survey,http://mitadmissions.org/blogs/entry/the_sam_survey,2286,0,0,0,0
Mar 9 2008,Paul B. '11,While You Wait,http://mitadmissions.org/blogs/entry/while_you_wait1,2286,0,0,0,0
Mar 9 2008,Ben Jones,Online Decisions To Be Released This Saturday,http://mitadmissions.org/blogs/entry/online_decisions_to_be_release_1,2286,0,0,0,0
Mar 8 2008,Snively '11,The Deep Breath Before the Plunge,http://mitadmissions.org/blogs/entry/the_deep_breath_before_the_plu,2287,0,0,0,0
Mar 8 2008,Daniel Barkowitz,Decision Diversion,http://mitadmissions.org/blogs/entry/decision_diversion,2287,0,0,0,0
Mar 7 2008,Daniel Barkowitz,MITs Financial Aid Enhancements are Released!,http://mitadmissions.org/blogs/entry/mits_financial_aid_enhancement,2288,1,0,0,1
Mar 6 2008,Paul B. '11,Rubbing Elbows,http://mitadmissions.org/blogs/entry/rubbing_elbows,2289,0,0,0,0
Mar 6 2008,Melis A. '08,The Great Debate: Latke vs. Hamentashen,http://mitadmissions.org/blogs/entry/the_great_debate_latke_vs_hame,2289,0,3,0,3
Mar 5 2008,Snively '11,Latke vs. Hamentashen Debate: LiveBlog,http://mitadmissions.org/blogs/entry/latke_vs_hamentashen_debate_li,2290,0,0,0,0
Mar 5 2008,Melis A. '08,Jhumpa Lahiri visited MIT today!,http://mitadmissions.org/blogs/entry/jhumpa_lahiri_visited_mit_toda,2290,0,0,0,0
Mar 4 2008,Daniel Barkowitz,MIT responds to Senators Baucus and Grassleys Request,http://mitadmissions.org/blogs/entry/mit_responds_to_senators_baucu,2291,0,0,0,0
Mar 4 2008,Snively '11,I AM THE MASTER!!!,http://mitadmissions.org/blogs/entry/i_am_the_master,2291,0,1,0,1
Mar 4 2008,Lulu L. '09,Quantum Mechanics,http://mitadmissions.org/blogs/entry/quantum_mechanics,2291,0,0,0,0
Mar 3 2008,Melis A. '08,Scholarship for future engineers,http://mitadmissions.org/blogs/entry/scholarship_for_future_enginee,2292,0,0,0,0
Mar 3 2008,Paul B. '11,Its All Going To Be Okay,http://mitadmissions.org/blogs/entry/its_all_going_to_be_okay,2292,0,0,0,0
Mar 3 2008,Snively '11,Debunked,http://mitadmissions.org/blogs/entry/debunked,2292,0,0,0,0
Feb 29 2008,Chris S. '11,Just Because Its 2/29,http://mitadmissions.org/blogs/entry/just_because_its_229,2295,0,0,0,0
Feb 29 2008,Jess K. '10,"Half Harvard, Half MIT",http://mitadmissions.org/blogs/entry/half_harvard_half_mit,2295,3,2,0,5
Feb 29 2008,Daniel Barkowitz,MITs President Announces our Position on Financial Aid,http://mitadmissions.org/blogs/entry/mits_president_announces_our_p,2295,0,0,0,0
Feb 29 2008,Melis A. '08,MIT is going to pump you up!,http://mitadmissions.org/blogs/entry/mit_is_going_to_pump_you_up,2295,0,0,0,0
Feb 29 2008,Snively '11,A Hack and Advice,http://mitadmissions.org/blogs/entry/a_hack_and_advice,2295,0,0,0,0
Feb 28 2008,Paul B. '11,A Nerds Paradise,http://mitadmissions.org/blogs/entry/a_nerds_paradise,2296,0,0,0,0
Feb 27 2008,Evan B. '10,The Impossible Design Project,http://mitadmissions.org/blogs/entry/the_impossible_design_project,2297,0,0,0,0
Feb 27 2008,Snively '11,Karma,http://mitadmissions.org/blogs/entry/karma_1,2297,0,0,0,0
Feb 27 2008,ARTalk,Seamless And A Seamless Transition,http://mitadmissions.org/blogs/entry/seamless_and_a_seamless_transi,2297,0,1,2,3
Feb 26 2008,Chris S. '11,Its Not Always Rainbows and Butterflies,http://mitadmissions.org/blogs/entry/its_not_always_rainbows_and_bu,2298,2,2,2,6
Feb 26 2008,Snively '11,Its not all happy,http://mitadmissions.org/blogs/entry/its_not_all_happy,2298,0,0,0,0
Feb 26 2008,Paul B. '11,"Orgo and physics and math, oh my",http://mitadmissions.org/blogs/entry/orgo_and_physics_and_math_oh_my,2298,0,0,0,0
Feb 24 2008,Anthony R. '09,Living Off Campus,http://mitadmissions.org/blogs/entry/living_off_campus,2300,1,1,15,17
Feb 23 2008,Snively '11,Fun in NYC Part 1,http://mitadmissions.org/blogs/entry/fun_in_nyc_part_1,2301,0,0,0,0
Feb 23 2008,Snively '11,Fun in NYC Part 2,http://mitadmissions.org/blogs/entry/fun_in_nyc_part_2,2301,0,0,0,0
Feb 22 2008,Karen F. '11,The Infected,http://mitadmissions.org/blogs/entry/the_infected,2302,0,0,0,0
Feb 22 2008,Snively '11,Math = Broken,http://mitadmissions.org/blogs/entry/math_broken,2302,0,0,0,0
Feb 21 2008,Matt McGann '00,The Years of the Rat,http://mitadmissions.org/blogs/entry/the_years_of_the_rat,2303,3,5,2,10
Feb 20 2008,Jess K. '10,The Class of 2010 Ring Premiere,http://mitadmissions.org/blogs/entry/10_ring_premiere,2304,0,0,0,0
Feb 20 2008,Paul B. '11,Dark Side of the Moon,http://mitadmissions.org/blogs/entry/dark_side_of_the_moon,2304,0,0,0,0
Feb 20 2008,Melis A. '08,Smaller than the eye can see,http://mitadmissions.org/blogs/entry/smaller_than_the_eye_can_see,2304,0,0,0,0
Feb 19 2008,Laura N. '09,Parliamo Italiano!,http://mitadmissions.org/blogs/entry/parliamo_italiano,2305,0,0,0,0
Feb 19 2008,Snively '11,Some Funnies,http://mitadmissions.org/blogs/entry/some_funnies,2305,0,0,0,0
Feb 18 2008,Sam M. '07,An old mans thought of school,http://mitadmissions.org/blogs/entry/an_old_mans_thought_of_school,2306,0,2,0,2
Feb 18 2008,Chris S. '11,Of MUN and Academia,http://mitadmissions.org/blogs/entry/of_mun_and_academia,2306,0,2,0,2
Feb 16 2008,Karen F. '11,"Wild Parties, Vaginas and Suburbia",http://mitadmissions.org/blogs/entry/wild_parties_vaginas_and_subur,2308,0,0,0,0
Feb 16 2008,Lulu L. '09,Its Beautiful,http://mitadmissions.org/blogs/entry/its_beautiful,2308,0,0,0,0
Feb 15 2008,Jess K. '10,Moving Out,http://mitadmissions.org/blogs/entry/moving_out,2309,0,0,0,0
Feb 15 2008,Evan B. '10,Keep Holy the Month of IAP For It Is a Time of Rest,http://mitadmissions.org/blogs/entry/keep_holy_the_month_of_iap_for,2309,0,0,0,0
Feb 14 2008,Melis A. '08,Guest Entry: Leadership @ MIT,http://mitadmissions.org/blogs/entry/guest_entry_leadership_mit,2310,0,0,0,0
Feb 14 2008,Karen F. '11,The Political Process,http://mitadmissions.org/blogs/entry/the_political_process,2310,0,0,0,0
Feb 14 2008,Paul B. '11,Happy Valentines Day from MIT,http://mitadmissions.org/blogs/entry/happy_valentines_day_from_mit,2310,0,0,0,0
Feb 14 2008,Snively '11,Happy Valentines Day,http://mitadmissions.org/blogs/entry/happy_valentines_day,2310,0,0,0,0
Feb 13 2008,Snively '11,Barker Engineering Library,http://mitadmissions.org/blogs/entry/barker_engineering_library,2311,0,0,0,0
Feb 12 2008,ARTalk,Following My Passions At MIT,http://mitadmissions.org/blogs/entry/following_my_passions_at_mit,2312,0,0,0,0
Feb 12 2008,ROTC,A Day In The Life,http://mitadmissions.org/blogs/entry/a_day_in_the_life_1,2312,0,0,0,0
Feb 10 2008,Snively '11,Hot Dogs,http://mitadmissions.org/blogs/entry/hot_dogs_1,2314,0,0,0,0
Feb 9 2008,Matt McGann '00,Physics Prof. Peter Fisher on Conan,http://mitadmissions.org/blogs/entry/physics_prof_peter_fisher_on_c,2315,1,2,1,4
Feb 9 2008,Laura N. '09,Whoooo!,http://mitadmissions.org/blogs/entry/whoooo,2315,0,0,0,0
Feb 8 2008,Snively '11,Sunny day - Sweepin the clouds away,http://mitadmissions.org/blogs/entry/sunny_day_sweepin_the_clouds_a,2316,0,0,0,0
Feb 8 2008,Paul B. '11,Hilarity with Jeremy,http://mitadmissions.org/blogs/entry/hilarity_with_jeremy,2316,0,0,0,0
Feb 8 2008,Cambridge,Tour of Town,http://mitadmissions.org/blogs/entry/tour_of_town,2316,0,0,0,0
Feb 8 2008,Chris S. '11,Summer Lovin,http://mitadmissions.org/blogs/entry/summer_lovin_1,2316,0,0,0,0
Feb 7 2008,Evan B. '10,More Psets!,http://mitadmissions.org/blogs/entry/more_psets,2317,0,0,0,0
Feb 6 2008,Snively '11,The Holy Grail of Classes,http://mitadmissions.org/blogs/entry/the_holy_grail_of_classes,2318,4,1,6,11
Feb 6 2008,Snively '11,Blogging About Blogging,http://mitadmissions.org/blogs/entry/blogging_about_blogging,2318,0,0,0,0
Feb 5 2008,The Humanitarian Blog,Harvard-MIT Student Debate on Pakistan this Friday,http://mitadmissions.org/blogs/entry/harvardmit_student_debate_on_p,2319,0,0,0,0
Feb 5 2008,Bryan G. Nance,MIT vs. Chuck Norris,http://mitadmissions.org/blogs/entry/mit_vs_chuck_norris,2319,2,5,0,7
Feb 5 2008,Paul B. '11,Simply Brothers,http://mitadmissions.org/blogs/entry/simply_brothers,2319,0,0,0,0
Feb 4 2008,Chris S. '11,Livin la Vida Espaola (Pt. 2),http://mitadmissions.org/blogs/entry/livin_la_vida_espanola_pt_2,2320,0,0,0,0
Feb 3 2008,Snively '11,The Whole 6.270 Story,http://mitadmissions.org/blogs/entry/post_11,2321,0,0,0,0
Feb 2 2008,Laura N. '09,What do you want to be when you grow up?,http://mitadmissions.org/blogs/entry/what_do_you_want_to_be_when_yo,2322,0,0,0,0
Feb 2 2008,Lulu L. '09,Teehee,http://mitadmissions.org/blogs/entry/teehee,2322,0,0,0,0
Jan 31 2008,ARTalk,It All Started with a Sound Board,http://mitadmissions.org/blogs/entry/it_all_started_with_a_sound_bo,2324,0,0,0,0
Jan 31 2008,Snively '11,6.270,http://mitadmissions.org/blogs/entry/six_6270,2324,0,0,0,0
Jan 30 2008,Karen F. '11,Bad Ideas,http://mitadmissions.org/blogs/entry/bad_ideas,2325,0,0,0,0
Jan 29 2008,Lulu L. '09,Life as a Physics Major- Research and Junior Lab(Part 2),http://mitadmissions.org/blogs/entry/life_as_a_physics_major_resear,2326,0,0,0,0
Jan 28 2008,Snively '11,Exactly the Same,http://mitadmissions.org/blogs/entry/exactly_the_same,2327,0,0,0,0
Jan 27 2008,Jess K. '10,For love of Baxter,http://mitadmissions.org/blogs/entry/for_love_of_baxter,2328,0,0,0,0
Jan 26 2008,Karen F. '11,Delicious Things,http://mitadmissions.org/blogs/entry/delicious_things_1,2329,0,0,0,0
Jan 25 2008,Snively '11,Bang! Update [3],http://mitadmissions.org/blogs/entry/bang,2330,0,0,0,0
Jan 24 2008,Matt McGann '00,The State of the Mail: Opened & Processed,http://mitadmissions.org/blogs/entry/the_state_of_the_mail_opened_p,2331,0,0,0,0
Jan 24 2008,Paul B. '11,"Riddles, Research, and Nerds with Power Tools",http://mitadmissions.org/blogs/entry/riddles_research_and_nerds_with_power_tools,2331,1,0,0,1
Jan 24 2008,Laura N. '09,Religious Discussions,http://mitadmissions.org/blogs/entry/religious_discussions,2331,0,0,0,0
Jan 23 2008,Bryan O. '09,The View from 1000 Feet,http://mitadmissions.org/blogs/entry/the_view_from_1000_feet,2332,0,0,0,0
Jan 23 2008,Snively '11,Danger Danger!,http://mitadmissions.org/blogs/entry/danger_danger,2332,0,0,0,0
Jan 23 2008,The Humanitarian Blog,Trip to India,http://mitadmissions.org/blogs/entry/trip_to_india,2332,0,0,0,0
Jan 23 2008,Melis A. '08,It all comes to this,http://mitadmissions.org/blogs/entry/it_all_comes_to_this,2332,0,0,0,0
Jan 22 2008,Laura N. '09,How to use these blogs,http://mitadmissions.org/blogs/entry/how_to_use_these_blogs,2333,0,0,0,0
Jan 22 2008,Keri G. '10,"Behold, a day job!",http://mitadmissions.org/blogs/entry/behold_a_day_job,2333,0,0,0,0
Jan 22 2008,Lulu L. '09,A Break from Break,http://mitadmissions.org/blogs/entry/a_break_from_break,2333,0,0,0,0
Jan 21 2008,Jess K. '10,Interview with a Mystery Hunt Winner,http://mitadmissions.org/blogs/entry/interview_with_a_mystery_hunt,2334,0,0,0,0
Jan 21 2008,Chris S. '11,Livin la Vida Espaola (Pt. 1),http://mitadmissions.org/blogs/entry/livin_la_vida_espanola_pt_1,2334,1,0,0,1
Jan 21 2008,mitblogs,Faculty Luncheon for Local* Admitted Students,http://mitadmissions.org/blogs/entry/faculty_luncheon_for_local_adm,2334,0,0,0,0
Jan 21 2008,ARTalk,Art Keeps Me Sane At MIT,http://mitadmissions.org/blogs/entry/art_keeps_me_sane_at_mit,2334,0,0,0,0
Jan 20 2008,Evan B. '10,And Its Over!,http://mitadmissions.org/blogs/entry/and_its_over,2335,0,0,0,0
Jan 20 2008,Evan B. '10,Whats This Mystery Hunt Thing?,http://mitadmissions.org/blogs/entry/whats_this_mystery_hunt_thing,2335,0,0,0,0
Jan 20 2008,Snively '11,How Many Liveblogs Can We Get Onto One Page?!,http://mitadmissions.org/blogs/entry/how_many_liveblogs_can_we_get,2335,0,0,0,0
Jan 18 2008,Laura N. '09,Semi-Real Time Mystery Hunt Update v. 2008,http://mitadmissions.org/blogs/entry/semireal_time_mystery_hunt_upd_1,2337,0,0,0,0
Jan 18 2008,Bryan O. '09,Mystery Hunt LiveBlog,http://mitadmissions.org/blogs/entry/mystery_hunt_liveblog,2337,0,0,0,0
Jan 18 2008,Matt McGann '00,Mystery Hunt 2008 Begins!,http://mitadmissions.org/blogs/entry/mystery_hunt_2008_begins,2337,0,0,0,0
Jan 17 2008,Paul B. '11,Telethon FunSquared,http://mitadmissions.org/blogs/entry/telethon_funsquared,2338,0,0,0,0
Jan 17 2008,Snively '11,Telethon Live Blog,http://mitadmissions.org/blogs/entry/telethon_live_blog_1,2338,0,0,0,0
Jan 17 2008,Snively '11,Adonde?,http://mitadmissions.org/blogs/entry/adonde,2338,0,0,0,0
Jan 17 2008,Jess K. '10,"Hayden Christensen Comes to MIT, Looks Pretty",http://mitadmissions.org/blogs/entry/hayden_christensen_comes_to_mi,2338,0,0,0,0
Jan 16 2008,Matt McGann '00,Juniors: MIT and other summer programs,http://mitadmissions.org/blogs/entry/juniors_mit_and_other_summer_p,2339,2,7,1,10
Jan 16 2008,Melis A. '08,The Abominable Snowman,http://mitadmissions.org/blogs/entry/the_abominable_snowman,2339,0,0,0,0
Jan 15 2008,Snively '11,The Igs,http://mitadmissions.org/blogs/entry/the_igs,2340,0,0,0,0
Jan 14 2008,Paul B. '11,"One Extraordinary Week, Plus Ferrets",http://mitadmissions.org/blogs/entry/one_extraordinary_week_plus_fe,2341,0,0,0,0
Jan 13 2008,Keri G. '10,Why I do too much stuff at MIT,http://mitadmissions.org/blogs/entry/i_do_too_much_stuff,2342,0,0,0,0
Jan 13 2008,Snively '11,The Coop,http://mitadmissions.org/blogs/entry/the_coop,2342,0,3,0,3
Jan 12 2008,Paul B. '11,Birthday Boy Ben,http://mitadmissions.org/blogs/entry/birthday_boy_ben,2343,0,0,0,0
Jan 12 2008,Paul B. '11,Boston Rain,http://mitadmissions.org/blogs/entry/boston_rain_1,2343,0,0,0,0
Jan 12 2008,Matt McGann '00,Wheres My Stuff?,http://mitadmissions.org/blogs/entry/wheres_my_stuff1,2343,0,0,0,0
Jan 12 2008,Matt McGann '00,Wheres My Stuff?,http://mitadmissions.org/blogs/entry/wheres_my_stuff,2343,0,0,0,0
Jan 11 2008,Karen F. '11,An Entry About Snow,http://mitadmissions.org/blogs/entry/an_entry_about_snow,2344,0,0,0,0
Jan 10 2008,ARTalk,Introduction To ARTalk,http://mitadmissions.org/blogs/entry/introduction_to_artalk,2345,0,0,0,0
Jan 10 2008,Laura N. '09,Ducks vs. Army Men!,http://mitadmissions.org/blogs/entry/ducks_vs_army_men,2345,0,0,0,0
Jan 10 2008,Snively '11,Comfort Matters,http://mitadmissions.org/blogs/entry/comfort_matters_1,2345,0,0,0,0
Jan 10 2008,Jess K. '10,Ambulance! Ambulance!,http://mitadmissions.org/blogs/entry/ambulance_ambulance,2345,0,0,0,0
Jan 9 2008,Melis A. '08,Global warming?,http://mitadmissions.org/blogs/entry/global_warming,2346,0,0,0,0
Jan 8 2008,Snively '11,Progression of Spirit,http://mitadmissions.org/blogs/entry/post_10,2347,0,0,0,0
Jan 8 2008,Evan B. '10,The End of an Era,http://mitadmissions.org/blogs/entry/the_end_of_an_era_1,2347,0,2,0,2
Jan 7 2008,Paul B. '11,The Space Between,http://mitadmissions.org/blogs/entry/the_space_between,2348,0,0,0,0
Jan 7 2008,Derrick B. '08,Sometimes we have fun,http://mitadmissions.org/blogs/entry/sometimes_we_have_fun_1,2348,0,0,0,0
Jan 5 2008,Jess K. '10,e) Other,http://mitadmissions.org/blogs/entry/e_other,2350,0,0,0,0
Jan 5 2008,Matt McGann '00,FIRST Robotics Kickoff,http://mitadmissions.org/blogs/entry/first_robotics_kickoff,2350,0,0,0,0
Jan 4 2008,Cambridge,"Vacation = Relaxation, right?",http://mitadmissions.org/blogs/entry/vacation_relaxation_right,2351,0,0,0,0
Jan 4 2008,Snively '11,Attack!,http://mitadmissions.org/blogs/entry/attack,2351,0,0,0,0
Jan 4 2008,Ben Jones,Odds & Ends,http://mitadmissions.org/blogs/entry/odds_ends_2,2351,0,0,0,0
Jan 4 2008,Chris S. '11,My Home,http://mitadmissions.org/blogs/entry/spacefiller____v,2351,0,0,0,0
Jan 3 2008,ROTC,Standing Out,http://mitadmissions.org/blogs/entry/standing_out_1,2352,0,0,0,0
Jan 3 2008,Laura N. '09,"Machine Shops, Part 2",http://mitadmissions.org/blogs/entry/machine_shops_part_2,2352,0,0,0,0
Jan 2 2008,Karen F. '11,The City On A Hill,http://mitadmissions.org/blogs/entry/the_city_on_a_hill,2353,0,0,0,0
Jan 2 2008,The Humanitarian Blog,Visit YouTube to Participate in the World Economic Forum!,http://mitadmissions.org/blogs/entry/visit_youtube_to_participate_i,2353,0,0,0,0
Jan 2 2008,Karen F. '11,The Wall,http://mitadmissions.org/blogs/entry/the_wall,2353,0,0,0,0
Dec 31 2007,Paul B. '11,What Though the Odds,http://mitadmissions.org/blogs/entry/what_though_the_odds_1,2355,0,5,0,5
Dec 21 2007,Derrick B. '08,At What Cost,http://mitadmissions.org/blogs/entry/at_what_cost_1,2365,0,1,0,1
Dec 20 2007,Laura N. '09,IHTFP,http://mitadmissions.org/blogs/entry/ihtfp,2366,2,1,0,3
Dec 18 2007,Jess K. '10,Low Balance,http://mitadmissions.org/blogs/entry/low_balance,2368,0,0,0,0
Dec 18 2007,Matt McGann '00,Deferred Students Update,http://mitadmissions.org/blogs/entry/deferred_students_update,2368,0,0,0,0
Dec 18 2007,Matt McGann '00,Admitted Students Update,http://mitadmissions.org/blogs/entry/admitted_students_update_2,2368,0,0,0,0
Dec 18 2007,Lulu L. '09,Choosing a Major,http://mitadmissions.org/blogs/entry/choosing_a_major,2368,0,0,0,0
Dec 17 2007,Ben Jones,MIT TechFair THINK Competition,http://mitadmissions.org/blogs/entry/mit_techfair_think_competitio,2369,0,0,0,0
Dec 17 2007,Bryan G. Nance,Enigma Gold Star Winners!,http://mitadmissions.org/blogs/entry/enigma_gold_star_winners,2369,0,0,0,0
Dec 17 2007,ROTC,MOUT Training Exercise With UNH ROTC,http://mitadmissions.org/blogs/entry/mout_training_exercise_with_un,2369,1,0,0,1
Dec 15 2007,Matt McGann '00,Admitted,http://mitadmissions.org/blogs/entry/admitted_1,2371,0,0,0,0
Dec 15 2007,Matt McGann '00,Deferred,http://mitadmissions.org/blogs/entry/deferred,2371,0,0,0,0
Dec 15 2007,Matt McGann '00,Not Admitted,http://mitadmissions.org/blogs/entry/not_admitted_2,2371,0,0,0,0
Dec 14 2007,Lulu L. '09,Getting a Physics Major - Part I,http://mitadmissions.org/blogs/entry/getting_a_physics_major_part_i,2372,0,0,0,0
Dec 13 2007,Melis A. '08,"Snow lovers, unite!",http://mitadmissions.org/blogs/entry/snow_lovers_unite,2373,0,0,0,0
Dec 13 2007,Chris S. '11,What Do These Numbers Have in Common?,http://mitadmissions.org/blogs/entry/what_do_these_numbers_have_in,2373,0,0,0,0
Dec 11 2007,Paul B. '11,Hack Study Break,http://mitadmissions.org/blogs/entry/hack_study_break,2375,10,13,15,38
Dec 10 2007,Jess K. '10,"Things To Do While Waiting for Decisions, Part II",http://mitadmissions.org/blogs/entry/things_to_do_while_waiting_for_1,2376,0,0,0,0
Dec 10 2007,Ben Jones,Early Action Decisions,http://mitadmissions.org/blogs/entry/early_action_decisions,2376,0,1,0,1
Dec 9 2007,The Humanitarian Blog,The Person Who Inspired Me to Start this Blog,http://mitadmissions.org/blogs/entry/the_person_who_inspired_me_to,2377,0,0,0,0
Dec 8 2007,Chris S. '11,Can You Save the Worlds Oceans?,http://mitadmissions.org/blogs/entry/can_you_save_the_worlds_oceans,2378,0,0,0,0
Dec 7 2007,Melis A. '08,A truly independent activities period,http://mitadmissions.org/blogs/entry/a_truly_independent_activities_1,2379,0,0,0,0
Dec 4 2007,Cambridge,Travels,http://mitadmissions.org/blogs/entry/travels,2382,0,0,0,0
Dec 4 2007,Lulu L. '09,Noam Chomsky Talk in 26-100,http://mitadmissions.org/blogs/entry/noam_chomsky_talk_in_26100,2382,0,0,0,0
Dec 3 2007,Chris S. '11,SNOW SNOW SNOW!,http://mitadmissions.org/blogs/entry/snow_snow_snow,2383,0,0,0,0
Dec 3 2007,Matt McGann '00,Snow(y) Day,http://mitadmissions.org/blogs/entry/snowy_day,2383,0,0,0,0
Dec 2 2007,Melis A. '08,Thomas Friedman on Energy & MIT,http://mitadmissions.org/blogs/entry/thomas_friedman_on_energy_mit,2384,0,0,0,0
Dec 1 2007,Mollie B. '06,An MIT wedding,http://mitadmissions.org/blogs/entry/an_mit_wedding,2385,2,2,1,5
Dec 1 2007,Melis A. '08,The Application Cycle,http://mitadmissions.org/blogs/entry/the_application_cycle,2385,0,0,0,0
Nov 30 2007,Jess K. '10,REX Now An Option for RBA Freshmen,http://mitadmissions.org/blogs/entry/rex_now_an_option_for_rba_fres,2386,0,0,0,0
Nov 29 2007,Matt McGann '00,"So much to do, so little time",http://mitadmissions.org/blogs/entry/so_much_to_do_so_little_time,2387,0,0,0,0
Nov 29 2007,Laura N. '09,Mechanical Sense of Humor,http://mitadmissions.org/blogs/entry/mechanical_sense_of_humor,2387,0,0,0,0
Nov 27 2007,Bryan G. Nance,An Enigma Wrapped In A Riddle,http://mitadmissions.org/blogs/entry/an_enigma_wrapped_in_a_riddle,2389,0,1,0,1
Nov 27 2007,Ben Jones,LOLZ CATS,http://mitadmissions.org/blogs/entry/lolz_cats,2389,0,1,0,1
Nov 26 2007,The Humanitarian Blog,One Students Crusade to Stop Genocide,http://mitadmissions.org/blogs/entry/one_students_crusade_to_stop_g,2390,0,1,0,1
Nov 25 2007,Jess K. '10,Turkeys and babies,http://mitadmissions.org/blogs/entry/turkeys_and_babies,2391,0,0,0,0
Nov 24 2007,Cambridge,Thanksgiving in England,http://mitadmissions.org/blogs/entry/thanksgiving_in_england,2392,0,0,0,0
Nov 24 2007,Chris S. '11,Thanksgiving Reflections,http://mitadmissions.org/blogs/entry/thanksgiving_reflections,2392,0,0,0,0
Nov 20 2007,Matt McGann '00,"Engineer, Blogger Rhodes Scholar (!)",http://mitadmissions.org/blogs/entry/engineer_blogger_rhodes_schola,2396,0,0,0,0
Nov 19 2007,Paul B. '11,Pauls Top Ten Common-Sense College Application Tips,http://mitadmissions.org/blogs/entry/pauls_top_ten_commonsense_coll,2397,8,9,0,17
Nov 19 2007,Karen F. '11,Inbox Insanity,http://mitadmissions.org/blogs/entry/mail_call,2397,0,0,0,0
Nov 19 2007,Jess K. '10,Burton 1 Social Club,http://mitadmissions.org/blogs/entry/burton_1_social_club,2397,0,0,0,0
Nov 15 2007,Matt McGann '00,You Complete Me,http://mitadmissions.org/blogs/entry/you_complete_me,2401,0,0,0,0
Nov 14 2007,Matt McGann '00,The Early Applications,http://mitadmissions.org/blogs/entry/the_early_applications,2402,0,0,0,0
Nov 13 2007,Cambridge,Sunsets,http://mitadmissions.org/blogs/entry/sunsets,2403,0,0,0,0
Nov 12 2007,Chris S. '11,17 Days,http://mitadmissions.org/blogs/entry/17_days,2404,0,0,0,0
Nov 11 2007,Melis A. '08,"As if course numbers werent enough: Learning your A, B, Cs, and OEs",http://mitadmissions.org/blogs/entry/as_if_course_numbers_werent_en,2405,0,0,0,0
Nov 9 2007,Keri G. '10,The things I do with my Friday afternoon,http://mitadmissions.org/blogs/entry/the_things_i_do_with_my_friday,2407,0,0,0,0
Nov 8 2007,Derrick B. '08,72 Hours,http://mitadmissions.org/blogs/entry/72_hours_1,2408,0,0,0,0
Nov 7 2007,Jess K. '10,Today I hit my TA with a door,http://mitadmissions.org/blogs/entry/today_i_hit_my_ta_with_a_door_1,2409,0,0,0,0
Nov 6 2007,Paul B. '11,V Storms the Senate,http://mitadmissions.org/blogs/entry/v_storms_the_senate,2410,0,0,0,0
Nov 6 2007,Keri G. '10,Why Im not a double major anymore,http://mitadmissions.org/blogs/entry/why_im_not_a_double_major_anym_1,2410,0,0,0,0
Nov 5 2007,Cambridge,"5th of November, Remembered",http://mitadmissions.org/blogs/entry/5th_of_november_remembered_1,2411,0,0,0,0
Nov 5 2007,Laura N. '09,"Machine Shops, Part 1",http://mitadmissions.org/blogs/entry/machine_shops_part_1,2411,0,1,1,2
Nov 5 2007,Paul B. '11,"Remember, Remember the Fifth of November",http://mitadmissions.org/blogs/entry/remember_remember_the_fifth_of,2411,0,0,0,0
Nov 4 2007,Matt McGann '00,"Nourishing bodies, enriching souls and minds",http://mitadmissions.org/blogs/entry/nourishing_bodies_enriching_so,2412,0,0,0,0
Nov 3 2007,Cambridge,"Study Breaks, Apple Pies, and Formal Halls",http://mitadmissions.org/blogs/entry/study_breaks_apple_pies_and_fo,2413,0,0,0,0
Nov 1 2007,Karen F. '11,Classes!,http://mitadmissions.org/blogs/entry/classes,2415,0,0,0,0
Nov 1 2007,Matt McGann '00,Deadline Day,http://mitadmissions.org/blogs/entry/deadline_day,2415,0,0,0,0
Oct 31 2007,Ben Jones,Answers To Questions Fall 2007,http://mitadmissions.org/blogs/entry/answers_to_questions_fall_2007,2416,0,0,0,0
Oct 31 2007,Jess K. '10,Orgo Halloween,http://mitadmissions.org/blogs/entry/orgo_halloween,2416,1,2,0,3
Oct 31 2007,Ben Jones,The Next Generation Of College Campus Tours?,http://mitadmissions.org/blogs/entry/the_next_generation_of_college,2416,0,0,0,0
Oct 31 2007,ROTC,The Spirit of Competition,http://mitadmissions.org/blogs/entry/the_spirit_of_competition,2416,0,0,0,0
Oct 31 2007,MISTI Program,Three Months In Paris,http://mitadmissions.org/blogs/entry/three_months_in_paris,2416,0,0,0,0
Oct 31 2007,The Humanitarian Blog,Global Poverty: This Is Our Crisis,http://mitadmissions.org/blogs/entry/global_poverty_this_is_our_cri,2416,0,0,0,0
Oct 29 2007,Jess K. '10,Excitement,http://mitadmissions.org/blogs/entry/excitement_1,2418,0,0,0,0
Oct 29 2007,Laura N. '09,Why Course 2A is Cooler than You,http://mitadmissions.org/blogs/entry/why_course_2a_is_cooler_than_y,2418,0,0,0,0
Oct 29 2007,Matt McGann '00,Supplemental Materials,http://mitadmissions.org/blogs/entry/supplemental_materials,2418,0,3,0,3
Oct 29 2007,Ben Jones,Soothing Words About Deadlines From Joanne Cummings,http://mitadmissions.org/blogs/entry/soothing_words_about_deadlines,2418,0,0,0,0
Oct 28 2007,Paul B. '11,Memories,http://mitadmissions.org/blogs/entry/memories_1,2419,0,0,0,0
Oct 27 2007,Jess K. '10,Blogging Scholarship Conclusion,http://mitadmissions.org/blogs/entry/blogging_scholarship_deadline,2420,0,0,0,0
Oct 26 2007,Chris S. '11,Notes on the Interview,http://mitadmissions.org/blogs/entry/post_8,2421,5,6,5,16
Oct 26 2007,Ben Jones,The Human Factor And String Theory,http://mitadmissions.org/blogs/entry/the_human_factor_and_string_th,2421,0,0,0,0
Oct 25 2007,Evan B. '10,Go Sox!,http://mitadmissions.org/blogs/entry/go_sox_1,2422,0,1,0,1
Oct 25 2007,The Humanitarian Blog,Setting up a Global Warming Research Centerin Antarctica,http://mitadmissions.org/blogs/entry/setting_up_a_global_warming_re,2422,2,0,0,2
Oct 24 2007,Matt McGann '00,Southern California Fires,http://mitadmissions.org/blogs/entry/southern_california_fires,2423,0,0,0,0
Oct 23 2007,Keri G. '10,"Work, friends, sleep - pick three",http://mitadmissions.org/blogs/entry/work_friends_sleep_-_pick_thre,2424,0,0,0,0
Oct 19 2007,The Humanitarian Blog,New Blog: Humanitarian Work At MIT,http://mitadmissions.org/blogs/entry/new_blog_humanitarian_work_at,2428,0,0,0,0
Oct 19 2007,ROTC,Into the Sunset,http://mitadmissions.org/blogs/entry/into_the_sunset,2428,0,0,0,0
Oct 18 2007,Cambridge,Cambridge Traditions and 5 Course Meals,http://mitadmissions.org/blogs/entry/cambridge_traditions_and_5_cou,2429,0,0,0,0
Oct 18 2007,Jess K. '10,The Great Wifi Outage of 2007,http://mitadmissions.org/blogs/entry/the_great_wifi_outage_of_2007,2429,0,0,0,0
Oct 18 2007,Matt McGann '00,Order of Operations,http://mitadmissions.org/blogs/entry/order_of_operations,2429,0,0,0,0
Oct 17 2007,Derrick B. '08,Youre Not Alone,http://mitadmissions.org/blogs/entry/youre_not_alone,2430,0,0,0,0
Oct 16 2007,Bryan G. Nance,Does MIT Offer Application Fee Waivers?,http://mitadmissions.org/blogs/entry/does_mit_offer_application_fee,2431,1,1,0,2
Oct 14 2007,Chris S. '11,What Makes You Tick?,http://mitadmissions.org/blogs/entry/post_7,2433,0,1,0,1
Oct 13 2007,Karen F. '11,One Life to Live,http://mitadmissions.org/blogs/entry/one_life_to_live,2434,0,0,0,0
Oct 13 2007,Jess K. '10,Why My 5.13 Problem Set Took All Day,http://mitadmissions.org/blogs/entry/why_my_513_problem_set_took_al,2434,1,2,2,5
Oct 13 2007,Karen F. '11,How I Learned To Stop Worrying And Love Physics,http://mitadmissions.org/blogs/entry/how_i_learned_to_stop_worrying,2434,2,1,0,3
Oct 13 2007,Bryan O. '09,Nonlinearity,http://mitadmissions.org/blogs/entry/nonlinearity,2434,0,0,0,0
Oct 11 2007,Matt McGann '00,Early Action Interview Deadline Approaching!,http://mitadmissions.org/blogs/entry/early_action_interview_deadlin,2436,0,1,1,2
Oct 10 2007,Jess K. '10,REX and the City,http://mitadmissions.org/blogs/entry/rex_and_the_city,2437,0,0,0,0
Oct 9 2007,Lulu L. '09,Come Together,http://mitadmissions.org/blogs/entry/come_together,2438,0,0,0,0
Oct 8 2007,Paul B. '11,New Kid on the Blogs,http://mitadmissions.org/blogs/entry/new_kid_on_the_blogs_1,2439,0,0,0,0
Oct 8 2007,Jess K. '10,Blogging Scholarship,http://mitadmissions.org/blogs/entry/blogging_scholarship_1,2439,0,0,0,0
Oct 5 2007,Jess K. '10,Pachyderm Photography,http://mitadmissions.org/blogs/entry/pachyderm_photography,2442,0,0,0,0
Oct 4 2007,Melis A. '08,David Berry: A Fearless Innovator with a Passion for MIT,http://mitadmissions.org/blogs/entry/david_berry_a_fearless_innovat,2443,0,0,0,0
Oct 3 2007,Cambridge,Punting,http://mitadmissions.org/blogs/entry/punting,2444,0,0,0,0
Oct 3 2007,ROTC,Helicopter Flight Training,http://mitadmissions.org/blogs/entry/helicopter_flight_training,2444,0,0,0,0
Oct 2 2007,Chris S. '11,"Hello, Ma Sheng Li Gong",http://mitadmissions.org/blogs/entry/hello_ma_sheng_li_gong,2445,0,0,0,0
Sep 30 2007,Derrick B. '08,An Atypical Saturday,http://mitadmissions.org/blogs/entry/an_atypical_saturday,2447,0,0,0,0
Sep 29 2007,Jess K. '10,Internet is Gonna Get Me,http://mitadmissions.org/blogs/entry/internet_is_gonna_get_me,2448,0,0,0,0
Sep 25 2007,Karen F. '11,Karen: A Short History,http://mitadmissions.org/blogs/entry/hi_im_karen,2452,0,0,0,0
Sep 25 2007,Ben Jones,Advice On The Essay,http://mitadmissions.org/blogs/entry/advice_on_the_essay,2452,2,3,7,12
Sep 24 2007,Keri G. '10,Two short stories,http://mitadmissions.org/blogs/entry/two_short_stories,2453,0,0,0,0
Sep 24 2007,Bryan G. Nance,Time To Have A Sit-Down With Your GC.,http://mitadmissions.org/blogs/entry/time_to_have_a_sitdown_with_yo,2453,0,0,0,0
Sep 21 2007,Evan B. '10,Blinky Lights (Part I),http://mitadmissions.org/blogs/entry/blinky_lights,2456,0,0,0,0
Sep 20 2007,Keri G. '10,Im still alive,http://mitadmissions.org/blogs/entry/im_still_alive,2457,0,0,0,0
Sep 20 2007,Derrick B. '08,The Scratches On My Mind,http://mitadmissions.org/blogs/entry/the_scratches_on_my_mind,2457,0,0,0,0
Sep 18 2007,Ben Jones,Overnight Program: Now Taking Requests,http://mitadmissions.org/blogs/entry/overnight_program_now_taking_r,2459,0,3,0,3
Sep 17 2007,Jess K. '10,Silent Dance Party,http://mitadmissions.org/blogs/entry/silent_dance_party,2460,0,0,0,0
Sep 17 2007,Evan B. '10,There Are No Uninteresting Things,http://mitadmissions.org/blogs/entry/there_are_no_uninteresting_thi,2460,0,0,0,0
Sep 17 2007,MISTI Program,MIT-France: To The Observatory of Paris and Beyond,http://mitadmissions.org/blogs/entry/mitfrance_to_the_observatory_o,2460,0,0,0,0
Sep 17 2007,Bryan G. Nance,Where In The World Is The Nance Effect?,http://mitadmissions.org/blogs/entry/where_in_the_world_is_the_nanc,2460,0,0,0,0
Sep 16 2007,Melis A. '08,101 Things to Do Before You Graduate from MIT,http://mitadmissions.org/blogs/entry/101_things_to_do_before_you_gr_1,2461,6,11,0,17
Sep 14 2007,Matt McGann '00,Ritual & Ceremony,http://mitadmissions.org/blogs/entry/ritual_ceremony,2463,0,0,0,0
Sep 14 2007,Laura N. '09,Hit in the Face: A Snively GuestBlog,http://mitadmissions.org/blogs/entry/hit_in_the_face_a_snively_gues,2463,0,0,0,0
Sep 12 2007,Lulu L. '09,Desired things,http://mitadmissions.org/blogs/entry/desired_things,2465,0,0,0,0
Sep 10 2007,Mitra L. '07,Running away with the field,http://mitadmissions.org/blogs/entry/running_away_with_the_field,2467,0,0,0,0
Sep 7 2007,Ben Jones,Blogger Decisions Released,http://mitadmissions.org/blogs/entry/blogger_decisions_released,2470,0,0,0,0
Sep 7 2007,Melis A. '08,"Prof. Ali Khademhosseini: Building tissues, cell-by-cell",http://mitadmissions.org/blogs/entry/prof_ali_khademhosseini_buildi,2470,0,0,0,0
Sep 5 2007,Matt McGann '00,First Day of School,http://mitadmissions.org/blogs/entry/first_day_of_school_1,2472,0,0,0,0
Sep 3 2007,Matt McGann '00,MIT goes on the road,http://mitadmissions.org/blogs/entry/mit_goes_on_the_road,2474,0,0,0,0
Aug 31 2007,Jess K. '10,Im Shipping Up to Boston,http://mitadmissions.org/blogs/entry/im_shipping_up_to_boston,2477,0,0,0,0
Aug 30 2007,Melis A. '08,"Incoming freshmen, come to the Activities Midway tomorrow!",http://mitadmissions.org/blogs/entry/incoming_freshmen_come_to_the,2478,0,0,0,0
Aug 28 2007,Public Service Center,Back at MIT: Reflecting and Restarting,http://mitadmissions.org/blogs/entry/back_at_mit_reflecting_and_res,2480,0,0,0,0
Aug 24 2007,Matt McGann '00,Law & Order: MIT Alum Unit,http://mitadmissions.org/blogs/entry/law_order_mit_alum_unit,2484,0,0,0,0
Aug 23 2007,Bryan O. '09,Didnt You Graduate?,http://mitadmissions.org/blogs/entry/didnt_you_graduate,2485,0,0,0,0
Aug 22 2007,Jess K. '10,Orientation and pre-approval,http://mitadmissions.org/blogs/entry/orientation_and_preapproval,2486,0,0,0,0
Aug 20 2007,Matt McGann '00,The Class of 2011 arrives,http://mitadmissions.org/blogs/entry/the_class_of_2011_arrives,2488,0,0,0,0
Aug 20 2007,Melis A. '08,Sororities @ MIT- Become a part of it!,http://mitadmissions.org/blogs/entry/sororities_mit_become_a_part_o,2488,0,1,0,1
Aug 19 2007,Melis A. '08,A grab bag filled with a magical camp and the Big Apple,http://mitadmissions.org/blogs/entry/a_grab_bag_filled_with_a_magic,2489,0,0,0,0
Aug 15 2007,Ben Jones,Wise Words From Mikey,http://mitadmissions.org/blogs/entry/wise_words_from_mikey,2493,0,0,0,0
Aug 15 2007,Evan B. '10,The Meaning of August,http://mitadmissions.org/blogs/entry/the_meaning_of_august,2493,0,0,0,0
Aug 14 2007,ROTC,Introduction To ROTC At MIT,http://mitadmissions.org/blogs/entry/introduction_to_rotc_at_mit,2494,0,3,0,3
Aug 14 2007,Public Service Center,Through her eyes,http://mitadmissions.org/blogs/entry/through_her_eyes,2494,0,0,0,0
Aug 10 2007,Keri G. '10,"I will, I will set this schedule on fire",http://mitadmissions.org/blogs/entry/schedule_on_fire,2498,0,0,0,0
Aug 9 2007,Ben Jones,Driving On The Infinite,http://mitadmissions.org/blogs/entry/driving_on_the_infinite,2499,4,1,17,22
Aug 7 2007,Public Service Center,PSC fellows: end of summer in India and Africa,http://mitadmissions.org/blogs/entry/psc_fellows_end_of_summer_in_i,2501,0,0,0,0
Aug 2 2007,Laurie Everett,"Where the Sun Shines, There Hack They",http://mitadmissions.org/blogs/entry/where_the_sun_shines_there_hac,2506,0,0,0,0
Jul 30 2007,Ben Jones,New Server,http://mitadmissions.org/blogs/entry/new_server,2509,1,0,0,1
Jul 30 2007,Public Service Center,PSC fellows and their projects wordwide,http://mitadmissions.org/blogs/entry/psc_fellows_and_their_projects,2509,0,0,0,0
Jul 28 2007,Sam M. '07,I who have nothing,http://mitadmissions.org/blogs/entry/i_who_have_nothing,2511,0,0,0,0
Jul 26 2007,Jess K. '10,College Shopping List,http://mitadmissions.org/blogs/entry/college_shopping_list_1,2513,0,3,0,3
Jul 25 2007,Matt McGann '00,Lauras UROP Advisor in American Inventor finals tonight!,http://mitadmissions.org/blogs/entry/lauras_urop_advisor_in_america,2514,0,0,0,0
Jul 23 2007,Public Service Center,Public Service Fellows Weekly Update #1,http://mitadmissions.org/blogs/entry/public_service_fellows_weekly,2516,0,0,0,0
Jul 20 2007,Laura N. '09,"Comments, UROPs, field trips, and OMG HP7!",http://mitadmissions.org/blogs/entry/post_4,2519,0,0,0,0
Jul 20 2007,Bryan O. '09,Harry Potter and the Infinite Corridor (updated!),http://mitadmissions.org/blogs/entry/harry_potter_and_the_infinite,2519,0,0,0,0
Jul 19 2007,Matt McGann '00,Pottermania hits MIT,http://mitadmissions.org/blogs/entry/pottermania_hits_mit,2520,0,0,0,0
Jul 18 2007,Lulu L. '09,A day without rain,http://mitadmissions.org/blogs/entry/a_day_without_rain,2521,0,0,0,0
Jul 12 2007,Sam M. '07,"Dig me, but dont bury me",http://mitadmissions.org/blogs/entry/dig_me_but_dont_bury_me,2527,0,0,0,0
Jul 12 2007,Matt McGann '00,Fireworks over MITs Great Dome,http://mitadmissions.org/blogs/entry/fireworks_over_mits_great_dome1,2527,0,0,0,0
Jul 12 2007,Matt McGann '00,Fireworks over MITs Great Dome,http://mitadmissions.org/blogs/entry/fireworks_over_mits_great_dome,2527,0,0,0,0
Jul 9 2007,Jess K. '10,07/07/07,http://mitadmissions.org/blogs/entry/seven_070707,2530,0,0,0,0
Jul 8 2007,Matt McGann '00,MIT Admissions Statistics 2007,http://mitadmissions.org/blogs/entry/mit_admissions_statistics_2007,2531,0,1,0,1
Jul 5 2007,Keri G. '10,Dont feed the squirrels,http://mitadmissions.org/blogs/entry/dont_feed_the_squirrels,2534,0,0,0,0
Jul 3 2007,Matt McGann '00,Fabulous Festivities & Fireworks for the Fourth,http://mitadmissions.org/blogs/entry/fabulous_festivities_fireworks,2536,0,0,0,0
Jul 2 2007,Anthony R. '09,Bring Your Audience to Work Day,http://mitadmissions.org/blogs/entry/bring_your_audience_to_work_da,2537,0,0,0,0
Jul 1 2007,Melis A. '08,MIT students launch Camp Kesem,http://mitadmissions.org/blogs/entry/mit_students_launch_camp_kesem,2538,0,0,0,0
Jun 29 2007,Keri G. '10,Its like a bag of sand!,http://mitadmissions.org/blogs/entry/its_like_a_bag_of_sand,2540,0,0,0,0
Jun 26 2007,Ben Jones,Call For Bloggers,http://mitadmissions.org/blogs/entry/call_for_bloggers,2543,0,0,0,0
Jun 26 2007,Daniel Barkowitz,Gone fishing in the Dead Sea,http://mitadmissions.org/blogs/entry/gone_fishing_in_the_dead_sea,2543,0,0,0,0
Jun 25 2007,Jess K. '10,Our mother shoulda just named you Laika!,http://mitadmissions.org/blogs/entry/our_mother_shoulda_just_named_1,2544,0,0,0,0
Jun 25 2007,Sam M. '07,I was out of bullets.,http://mitadmissions.org/blogs/entry/get_busy_living_or_get_busy_dy,2544,0,0,0,0
Jun 24 2007,Melis A. '08,McCormick: Girls Wanted,http://mitadmissions.org/blogs/entry/mccormick_girls_wanted,2545,0,1,0,1
Jun 22 2007,Lulu L. '09,This is my summer break,http://mitadmissions.org/blogs/entry/this_is_my_summer_break,2547,0,0,0,0
Jun 20 2007,Melis A. '08,Behind the scenes of Glamour: Part 2,http://mitadmissions.org/blogs/entry/behind_the_scenes_of_glamour_p,2549,0,0,0,0
Jun 20 2007,Matt McGann '00,The Magic Paint Brush,http://mitadmissions.org/blogs/entry/the_magic_paint_brush_1,2549,0,0,0,0
Jun 18 2007,Ben Jones,Random Monday Fun @ MIT,http://mitadmissions.org/blogs/entry/random_monday_fun_mit,2551,0,0,0,0
Jun 16 2007,Sam M. '07,I O Europe,http://mitadmissions.org/blogs/entry/dont_let_it_control_you,2553,0,0,0,0
Jun 13 2007,Melis A. '08,Ana Posada: Improving the production of an HIV medication,http://mitadmissions.org/blogs/entry/ana_posada_improving_the_produ,2556,0,0,0,0
Jun 13 2007,Laura N. '09,The end of an era,http://mitadmissions.org/blogs/entry/the_end_of_an_era,2556,0,0,0,0
Jun 13 2007,Ben Jones,Checking In,http://mitadmissions.org/blogs/entry/checking_in_2,2556,0,0,0,0
Jun 13 2007,Bryan O. '09,Graduation Picture Book,http://mitadmissions.org/blogs/entry/graduation_picture_book,2556,0,0,0,0
Jun 12 2007,Matt McGann '00,Testing requirements FAQ,http://mitadmissions.org/blogs/entry/testing_requirements_faq_1,2557,0,0,0,0
Jun 9 2007,Jess K. '10,Residence-Based Advising,http://mitadmissions.org/blogs/entry/residencebased_advising_1,2560,1,1,0,2
Jun 9 2007,Melis A. '08,Behind the scenes of Glamour: Part 1,http://mitadmissions.org/blogs/entry/behind_the_scenes_of_glamour_p_1,2560,0,0,0,0
Jun 7 2007,Jessie L. '07,"Its something unpredictable, but in the end its right",http://mitadmissions.org/blogs/entry/its_something_unpredictable_bu,2562,0,0,0,0
Jun 7 2007,Jess K. '10,Intermission,http://mitadmissions.org/blogs/entry/intermission,2562,0,0,0,0
Jun 6 2007,Mitra L. '07,The most important blog entry ever,http://mitadmissions.org/blogs/entry/the_most_important_blog_entry,2563,2,1,0,3
Jun 3 2007,Keri G. '10,Tales of a College Froshling,http://mitadmissions.org/blogs/entry/tales_of_a_college_froshling,2566,1,0,0,1
Jun 1 2007,Matt McGann '00,Consider a Gap Year,http://mitadmissions.org/blogs/entry/consider_a_gap_year,2568,0,0,0,0
May 31 2007,Bryan O. '09,Stories of Senioritis,http://mitadmissions.org/blogs/entry/stories_of_senioritis,2569,0,0,0,0
May 31 2007,Laurie Everett,Virginia Techs Commencement,http://mitadmissions.org/blogs/entry/virginia_techs_commencement,2569,0,0,0,0
May 29 2007,Mitra L. '07,50 (First) Dates,http://mitadmissions.org/blogs/entry/50_first_dates,2571,0,0,0,0
May 28 2007,Keri G. '10,Trans-Consciousness Messaging Protocol!,http://mitadmissions.org/blogs/entry/transconsciousness_messaging_p,2572,0,0,0,0
May 27 2007,Jess K. '10,Time Out,http://mitadmissions.org/blogs/entry/time_out,2573,0,0,0,0
May 26 2007,Sam M. '07,"Slow down, fast train.",http://mitadmissions.org/blogs/entry/slow_down_fast_train,2574,0,0,0,0
May 24 2007,Jess K. '10,Benzene Back,http://mitadmissions.org/blogs/entry/benzene_back,2576,0,0,0,0
May 23 2007,Lulu L. '09,Finals,http://mitadmissions.org/blogs/entry/finals_1,2577,0,0,0,0
May 21 2007,Keri G. '10,"If the roots are imaginary, then the dots will be blue",http://mitadmissions.org/blogs/entry/if_the_roots_are_imaginary_the,2579,0,0,0,0
May 21 2007,Bryan O. '09,YoYoPhones,http://mitadmissions.org/blogs/entry/yoyophones,2579,0,0,0,0
May 20 2007,Melis A. '08,MIT TechTV: Incredible videos from the MIT community,http://mitadmissions.org/blogs/entry/mit_techtv_incredible_videos_f_1,2580,0,0,0,0
May 18 2007,Anthony R. '09,A Week In Review,http://mitadmissions.org/blogs/entry/a_week_in_review,2582,0,0,0,0
May 17 2007,Matt McGann '00,Waitlist,http://mitadmissions.org/blogs/entry/waitlist_2,2583,0,0,0,0
May 17 2007,Matt McGann '00,Quick hello from Albuquerque,http://mitadmissions.org/blogs/entry/quick_hello_from_albuquerque,2583,0,0,0,0
May 16 2007,Melis A. '08,Interview with Emilienne: The Sophomore who does brain surgery,http://mitadmissions.org/blogs/entry/interview_with_emilienne_repak,2584,0,0,0,0
May 16 2007,Jess K. '10,The Final Countdown,http://mitadmissions.org/blogs/entry/the_final_countdown_1,2584,0,0,0,0
May 16 2007,Anthony R. '09,More on the Paris Metro,http://mitadmissions.org/blogs/entry/more_about_the_paris_metro,2584,0,0,0,0
May 15 2007,Laura N. '09,The best way to kill zombies,http://mitadmissions.org/blogs/entry/the_best_way_to_kill_zombies,2585,0,0,0,0
May 14 2007,Sam M. '07,I am a sad sad toaster made of glass.,http://mitadmissions.org/blogs/entry/i_am_a_sad_sad_toaster_made_of,2586,6,1,0,7
May 13 2007,Melis A. '08,"Interview with Hanhan Wang: EECS, robots, and more!",http://mitadmissions.org/blogs/entry/interview_with_hanhan_wang_eec_1,2587,0,0,0,0
May 12 2007,Matt McGann '00,MIT ISEF Reception,http://mitadmissions.org/blogs/entry/mit_isef_reception_1,2588,0,0,0,0
May 11 2007,Mitra L. '07,Senior Ball 2007,http://mitadmissions.org/blogs/entry/senior_ball_2007,2589,0,1,0,1
May 10 2007,Bryan O. '09,Knock On Wood,http://mitadmissions.org/blogs/entry/knock_on_wood,2590,0,0,0,0
May 9 2007,Matt McGann '00,In the South for prospective students; in the mail for incoming students,http://mitadmissions.org/blogs/entry/in_the_south_for_prospective_s,2591,0,0,0,0
May 8 2007,Jessie L. '07,Party!,http://mitadmissions.org/blogs/entry/party,2592,0,0,0,0
May 7 2007,Matt McGann '00,Live from Florida,http://mitadmissions.org/blogs/entry/live_from_florida,2593,0,0,0,0
May 7 2007,Mitra L. '07,Building 4 Odyssey,http://mitadmissions.org/blogs/entry/building_4_odyssey,2593,0,0,0,0
May 7 2007,Jess K. '10,FIRST POST!,http://mitadmissions.org/blogs/entry/first_post_2,2593,0,0,0,0
May 7 2007,Daniel Barkowitz,Now What?,http://mitadmissions.org/blogs/entry/now_what,2593,0,0,0,0
May 4 2007,Stu Schmill '86,Moving Forward,http://mitadmissions.org/blogs/entry/moving_forward,2596,0,0,0,0
Apr 26 2007,Ben Jones,Message From Ben And Matt,http://mitadmissions.org/blogs/entry/message_from_ben_and_matt,2604,0,0,0,0
Apr 25 2007,Lulu L. '09,Dropout Design and the Disco Dance Floor,http://mitadmissions.org/blogs/entry/dropout_design_and_the_disco_d,2605,0,1,0,1
Apr 24 2007,Laura N. '09,Class of 2009 Ring Delivery,http://mitadmissions.org/blogs/entry/class_of_2009_ring_delivery,2606,0,0,0,0
Apr 24 2007,Bryan O. '09,Drinking from the Firehose,http://mitadmissions.org/blogs/entry/drinking_from_the_firehose,2606,0,0,0,0
Apr 23 2007,Bryan O. '09,"Room E51-151, Please???",http://mitadmissions.org/blogs/entry/room_e51151_please,2607,0,0,0,0
Apr 22 2007,Bryan O. '09,Houston-area Suburbia kid Makes Trek to MIT Campus Preview Weekend with Mother,http://mitadmissions.org/blogs/entry/houstonarea_suburbia_kid_makes,2608,0,0,0,0
Apr 22 2007,Jess K. '10,Weather Machine,http://mitadmissions.org/blogs/entry/weather_machine,2608,0,0,0,0
Apr 21 2007,Melis A. '08,A sample of life in the past week,http://mitadmissions.org/blogs/entry/a_sample_of_life_in_the_past_w,2609,0,0,0,0
Apr 20 2007,Laura N. '09,Real Snow!,http://mitadmissions.org/blogs/entry/real_snow,2610,0,0,0,0
Apr 20 2007,Bryan O. '09,Testimony from an 11,http://mitadmissions.org/blogs/entry/where_can_i_find_room_e51151,2610,0,0,0,0
Apr 19 2007,Matt McGann '00,Entrepreneurship invasion,http://mitadmissions.org/blogs/entry/entrepreneurship_invasion_1,2611,0,0,0,0
Apr 18 2007,Laura N. '09,Yay CPW!,http://mitadmissions.org/blogs/entry/yay_cpw,2612,0,0,0,0
Apr 18 2007,Bryan O. '09,"CPW 2007: I Got Served, and It Felt Grrreat!!",http://mitadmissions.org/blogs/entry/cpw_2007_i_got_served_and_it_f,2612,0,0,0,0
Apr 18 2007,Mitra L. '07,Pre-MIT prep,http://mitadmissions.org/blogs/entry/premit_prep,2612,0,0,0,0
Apr 18 2007,Jessie L. '07,A follow-up,http://mitadmissions.org/blogs/entry/a_followup,2612,0,0,0,0
Apr 18 2007,Matt McGann '00,...More CPW,http://mitadmissions.org/blogs/entry/more_cpw,2612,0,0,0,0
Apr 17 2007,Matt McGann '00,Our thoughts go out to Virginia Tech.,http://mitadmissions.org/blogs/entry/our_thoughts_go_out_to_virgini,2613,0,0,0,0
Apr 17 2007,Keri G. '10,Gravity Rides Everything,http://mitadmissions.org/blogs/entry/gravity_rides_everything,2613,0,0,0,0
Apr 17 2007,Bryan O. '09,A Snively CPW,http://mitadmissions.org/blogs/entry/a_snively_cpw,2613,0,0,0,0
Apr 16 2007,Bryan O. '09,Freezing My @$$ off at CPW,http://mitadmissions.org/blogs/entry/freezing_my_off_at_cpw,2614,0,0,0,0
Apr 16 2007,Sam M. '07,Endless rain into a paper cup,http://mitadmissions.org/blogs/entry/endless_rain_into_a_paper_cup,2614,0,0,0,0
Apr 15 2007,Bryan O. '09,The Open-Ended Question,http://mitadmissions.org/blogs/entry/the_openended_question,2615,0,0,0,0
Apr 15 2007,Lulu L. '09,Sorry you didnt meet me :(,http://mitadmissions.org/blogs/entry/sorry_you_didnt_meet_me,2615,0,0,0,0
Apr 14 2007,Daniel Barkowitz,CPW Financial Aid Presentation,http://mitadmissions.org/blogs/entry/cpw_financial_aid_presentation,2616,0,0,0,0
Apr 13 2007,Matt McGann '00,CPW Friday liveblog,http://mitadmissions.org/blogs/entry/cpw_friday_liveblog,2617,0,0,0,0
Apr 12 2007,Laura N. '09,ZOMG CPW!,http://mitadmissions.org/blogs/entry/zomg_cpw,2618,0,0,0,0
Apr 12 2007,Matt McGann '00,CPW Thursday liveblog,http://mitadmissions.org/blogs/entry/cpw_thursday_liveblog_1,2618,0,0,0,0
Apr 12 2007,Sam M. '07,Samuel Maurers Day Off,http://mitadmissions.org/blogs/entry/samuel_maurers_day_off,2618,0,0,0,0
Apr 11 2007,Jess K. '10,Pre-Campus Preview Weekend,http://mitadmissions.org/blogs/entry/precampus_preview_weekend,2619,0,0,0,0
Apr 11 2007,Melis A. '08,A Day in the Life,http://mitadmissions.org/blogs/entry/a_day_in_the_life,2619,0,0,0,0
Apr 11 2007,Matt McGann '00,Thats where youll find me,http://mitadmissions.org/blogs/entry/thats_where_youll_find_me,2619,0,0,0,0
Apr 10 2007,Daniel Barkowitz,Give Financial Aid The Big ScrewI need your vote!!,http://mitadmissions.org/blogs/entry/give_financial_aid_the_big_scr,2620,0,0,0,0
Apr 10 2007,Matt McGann '00,More Updates from Cambridge,http://mitadmissions.org/blogs/entry/more_updates_from_cambridge,2620,0,0,0,0
Apr 10 2007,Bryan O. '09,CPW: Tips and Tricks,http://mitadmissions.org/blogs/entry/cpw_tips_and_tricks,2620,0,0,0,0
Apr 9 2007,Sam M. '07,Where is my mind?,http://mitadmissions.org/blogs/entry/where_is_my_mind,2621,0,0,0,0
Apr 9 2007,Matt McGann '00,A blog post about blog posts,http://mitadmissions.org/blogs/entry/a_blog_post_about_blog_posts,2621,0,0,0,0
Apr 9 2007,Daniel Barkowitz,Im going to be on the radioThursday 6:00 WMBR,http://mitadmissions.org/blogs/entry/im_going_to_be_on_the_radio_th,2621,0,0,0,0
Apr 9 2007,Bryan O. '09,Wanna be on the Radio? (Update),http://mitadmissions.org/blogs/entry/wanna_be_on_the_radio_update,2621,0,0,0,0
Apr 8 2007,Jess K. '10,"Work Hard, Play Hard",http://mitadmissions.org/blogs/entry/work_hard_play_hard,2622,0,0,0,0
Apr 8 2007,Keri G. '10,"Brains and treason and bouncy balls, oh my!",http://mitadmissions.org/blogs/entry/brains_and_treason_and_bouncy,2622,0,0,0,0
Apr 8 2007,Matt McGann '00,Some CPW Thoughts,http://mitadmissions.org/blogs/entry/some_cpw_thoughts,2622,0,0,0,0
Apr 8 2007,Anthony R. '09,"MIT, You Make Me Wanna Wait!",http://mitadmissions.org/blogs/entry/mit_you_make_me_wanna_wait,2622,0,0,0,0
Apr 7 2007,Bryan O. '09,Wanna be on the Radio?,http://mitadmissions.org/blogs/entry/wanna_be_on_the_radio,2623,0,0,0,0
Apr 7 2007,Bryan O. '09,Making the Switch: Chapter 2,http://mitadmissions.org/blogs/entry/making_the_switch_chapter_2,2623,0,0,0,0
Apr 4 2007,Melis A. '08,"Decisions, decisions",http://mitadmissions.org/blogs/entry/decisions_decisions_3,2626,0,0,0,0
Apr 4 2007,Ben Jones,Answers To Recent Questions!,http://mitadmissions.org/blogs/entry/answers_to_recent_questions,2626,0,0,0,0
Apr 2 2007,Jess K. '10,A Blog Entry About Transition,http://mitadmissions.org/blogs/entry/a_blog_entry_about_transition,2628,0,0,0,0
Mar 31 2007,Matt McGann '00,Admitted Students Parties Update,http://mitadmissions.org/blogs/entry/admitted_students_parties_upda,2630,0,0,0,0
Mar 31 2007,Bryan O. '09,Making The Switch,http://mitadmissions.org/blogs/entry/making_the_switch,2630,0,0,0,0
Mar 30 2007,Ben Jones,CPW Registration Browser Issues,http://mitadmissions.org/blogs/entry/cpw_registration_browser_issue,2631,0,0,0,0
Mar 29 2007,Jessie L. '07,Spring Break post,http://mitadmissions.org/blogs/entry/spring_break_post,2632,0,0,0,0
Mar 28 2007,Ben Jones,Brain Dump,http://mitadmissions.org/blogs/entry/brain_dump_1,2633,0,0,0,0
Mar 27 2007,MISTI Program,MIT-Italy: Working With Ferrari,http://mitadmissions.org/blogs/entry/mititaly_working_with_ferrari,2634,0,0,0,0
Mar 26 2007,Melis A. '08,News bites from the Institvte,http://mitadmissions.org/blogs/entry/news_bites_from_the_institvte,2635,0,0,0,0
Mar 26 2007,Bryan O. '09,Alive and In London,http://mitadmissions.org/blogs/entry/alive_and_in_london,2635,0,0,0,0
Mar 24 2007,Matt McGann '00,Admitted Students Parties,http://mitadmissions.org/blogs/entry/admitted_students_parties_2,2637,0,0,0,0
Mar 24 2007,Jess K. '10,Spoiled Milk,http://mitadmissions.org/blogs/entry/spoiled_milk,2637,0,0,0,0
Mar 23 2007,Bryan O. '09,Spring Break!,http://mitadmissions.org/blogs/entry/spring_break_1,2638,0,0,0,0
Mar 23 2007,Matt McGann '00,Im embarrassed to be writing this entry.,http://mitadmissions.org/blogs/entry/im_embarrassed_to_be_writing_t_1,2638,0,0,0,0
Mar 23 2007,Mitra L. '07,Bloggers invade LA,http://mitadmissions.org/blogs/entry/bloggers_invade_la,2638,0,0,0,0
Mar 21 2007,Matt McGann '00,The return of Questions Omnibus,http://mitadmissions.org/blogs/entry/the_return_of_questions_omnibu,2640,0,0,0,0
Mar 21 2007,Mollie B. '06,Happily ever after,http://mitadmissions.org/blogs/entry/happily_ever_after_1,2640,0,0,0,0
Mar 21 2007,Jess K. '10,Tell Me Baby,http://mitadmissions.org/blogs/entry/tell_me_baby,2640,0,0,0,0
Mar 20 2007,Matt McGann '00,Admitted Students Update,http://mitadmissions.org/blogs/entry/admitted_students_update,2641,0,0,0,0
Mar 20 2007,Matt McGann '00,Waitlist post,http://mitadmissions.org/blogs/entry/waitlist_post_1,2641,0,0,0,0
Mar 19 2007,Mitra L. '07,The Namesake,http://mitadmissions.org/blogs/entry/the_namesake,2642,0,0,0,0
Mar 19 2007,Laura N. '09,"Decisions, decisions",http://mitadmissions.org/blogs/entry/decisions_decisions_1,2642,0,0,0,0
Mar 17 2007,Matt McGann '00,MIT Admissions 2007,http://mitadmissions.org/blogs/entry/mit_admissions_2007,2644,0,0,0,0
Mar 17 2007,Ben Jones,Admitted,http://mitadmissions.org/blogs/entry/admitted,2644,0,0,0,0
Mar 17 2007,Ben Jones,Waitlisted,http://mitadmissions.org/blogs/entry/waitlisted,2644,1,0,0,1
Mar 17 2007,Ben Jones,Not Admitted,http://mitadmissions.org/blogs/entry/not_admitted,2644,0,0,0,0
Mar 16 2007,Melis A. '08,Biodiesel@MIT: Turning trash into black gold,http://mitadmissions.org/blogs/entry/biodieselmit_turning_trash_int,2645,0,0,0,0
Mar 16 2007,Bryan O. '09,Take Deep Breaths :),http://mitadmissions.org/blogs/entry/take_deep_breaths,2645,0,0,0,0
Mar 15 2007,Sam M. '07,This one goes out to the parent,http://mitadmissions.org/blogs/entry/this_one_goes_out_to_the_paren_1,2646,0,0,0,0
Mar 15 2007,Matt McGann '00,This one goes out to the parents,http://mitadmissions.org/blogs/entry/this_one_goes_out_to_the_paren,2646,0,0,0,0
Mar 14 2007,Jess K. '10,Orgo Birthday,http://mitadmissions.org/blogs/entry/orgo_birthday,2647,0,0,0,0
Mar 14 2007,Bryan O. '09,Happy Pi Day!!!,http://mitadmissions.org/blogs/entry/happy_pi_day_2,2647,0,1,0,1
Mar 13 2007,Melis A. '08,MIT OpenLabWare: A sneak peak at research @ MIT,http://mitadmissions.org/blogs/entry/mit_openlabware_a_sneak_peak_a,2648,0,0,0,0
Mar 12 2007,Cambridge,More Notes From The UK,http://mitadmissions.org/blogs/entry/more_notes_from_the_uk,2649,0,0,0,0
Mar 12 2007,Mitra L. '07,You cant live without clean water,http://mitadmissions.org/blogs/entry/you_cant_live_without_clean_wa,2649,0,0,0,0
Mar 12 2007,Ben Jones,Online Decisions To Be Released This Saturday,http://mitadmissions.org/blogs/entry/online_decisions_to_be_release,2649,0,0,0,0
Mar 10 2007,Bryan O. '09,nth Annual Concert in Bad Taste,http://mitadmissions.org/blogs/entry/nth_annual_concert_in_bad_tast,2651,0,0,0,0
Mar 10 2007,Jessie L. '07,"Oh look, an update",http://mitadmissions.org/blogs/entry/oh_look_an_update,2651,0,0,0,0
Mar 9 2007,Mitra L. '07,What do you do with a BS in econ?,http://mitadmissions.org/blogs/entry/what_do_you_do_with_a_bs_in_ec,2652,0,0,0,0
Mar 8 2007,Keri G. '10,"Thats right, youre sick",http://mitadmissions.org/blogs/entry/thats_right_youre_sick,2653,0,0,0,0
Mar 6 2007,Matt McGann '00,Financial aid news & more,http://mitadmissions.org/blogs/entry/financial_aid_news_more,2655,0,0,0,0
Mar 6 2007,Laurie Everett,The Future of Work,http://mitadmissions.org/blogs/entry/the_future_of_work,2655,0,0,0,0
Mar 6 2007,Bryan O. '09,I am Treasured :),http://mitadmissions.org/blogs/entry/i_am_treasured,2655,0,0,0,0
Mar 5 2007,Melis A. '08,Lets talk about scienceand chocolate,http://mitadmissions.org/blogs/entry/lets_talk_about_scienceand_cho,2656,0,0,0,0
Mar 4 2007,Sam M. '07,The Marching Band Refused to Yield,http://mitadmissions.org/blogs/entry/the_marching_band_refused_to_y,2657,2,1,0,3
Mar 3 2007,Ben Jones,The Mystery Of The Missing Application Tracking Portlet,http://mitadmissions.org/blogs/entry/the_mystery_of_the_missing_app,2658,0,0,0,0
Mar 2 2007,Lulu L. '09,Advice youve heard before and a story you havent,http://mitadmissions.org/blogs/entry/advice_youve_heard_before_and,2659,7,6,1,14
Mar 1 2007,Matt McGann '00,Davidson Fellows scholarship program,http://mitadmissions.org/blogs/entry/davidson_fellows_scholarship_p,2660,0,0,0,0
Feb 28 2007,Bryan O. '09,Life as a Talent Scout,http://mitadmissions.org/blogs/entry/life_as_a_talent_scout,2661,0,0,0,0
Feb 28 2007,Keri G. '10,"Well, at least you didnt fail, right?",http://mitadmissions.org/blogs/entry/well_at_least_you_didnt_fail_r,2661,0,0,0,0
Feb 28 2007,Chancellor Eric Grimson,MIT Students Operate On Hawaii Time!,http://mitadmissions.org/blogs/entry/mit_students_operate_on_hawaii,2661,14,3,1,18
Feb 25 2007,Sam M. '07,Ill bet you got waylaid!,http://mitadmissions.org/blogs/entry/ill_bet_you_got_waylaid,2664,0,0,0,0
Feb 25 2007,Anthony R. '09,Rethinking the Paris Metro,http://mitadmissions.org/blogs/entry/rethinking_the_paris_metro,2664,0,0,0,0
Feb 24 2007,Bryan O. '09,A Tale of Two Classes,http://mitadmissions.org/blogs/entry/a_tale_of_two_classes,2665,0,0,0,0
Feb 23 2007,Mitra L. '07,NM - u?,http://mitadmissions.org/blogs/entry/nm_u,2666,0,0,0,0
Feb 22 2007,Jess K. '10,Deprotonated,http://mitadmissions.org/blogs/entry/deprotonated,2667,0,0,0,0
Feb 22 2007,Daniel Barkowitz,The Son of Updates,http://mitadmissions.org/blogs/entry/the_son_of_updates,2667,0,0,0,0
Feb 22 2007,Ben Jones,MIT Idol,http://mitadmissions.org/blogs/entry/mit_idol_1,2667,0,0,0,0
Feb 21 2007,Sam M. '07,"Some Megaphone, Pressed Against An Insects Brain",http://mitadmissions.org/blogs/entry/some_megaphone,2668,0,0,0,0
Feb 21 2007,Melis A. '08,Design Squad: Pretty much the opposite of The O.C.,http://mitadmissions.org/blogs/entry/design_squad_pretty_much_the_o,2668,0,0,0,0
Feb 20 2007,Daniel Barkowitz,Math Fun (updated),http://mitadmissions.org/blogs/entry/math_fun,2669,0,0,0,0
Feb 20 2007,Keri G. '10,"Welcome to Senior Haus, version 2.0",http://mitadmissions.org/blogs/entry/welcome_to_senior_haus_version,2669,0,0,0,0
Feb 20 2007,Laura N. '09,The 2009 Brass Rat,http://mitadmissions.org/blogs/entry/the_2009_brass_rat,2669,0,0,0,0
Feb 19 2007,Sam M. '07,Maybe Im Amazed,http://mitadmissions.org/blogs/entry/amazing,2670,0,0,0,0
Feb 18 2007,Matt McGann '00,Happy Year of the Pig,http://mitadmissions.org/blogs/entry/happy_year_of_the_pig,2671,0,0,0,0
Feb 18 2007,Laura N. '09,Knife fight with a biker gang,http://mitadmissions.org/blogs/entry/knife_fight_with_a_biker_gang,2671,0,0,0,0
Feb 17 2007,Matt McGann '00,Comics for IAP,http://mitadmissions.org/blogs/entry/comics_for_iap,2672,0,0,0,0
Feb 17 2007,Lulu L. '09,Pictures that dont belong anywhere else - Part I,http://mitadmissions.org/blogs/entry/pictures_that_dont_belong_anyw,2672,0,0,0,0
Feb 16 2007,Daniel Barkowitz,Some more updates,http://mitadmissions.org/blogs/entry/some_more_updates,2673,0,0,0,0
Feb 15 2007,Keri G. '10,Welcome to Senior Haus,http://mitadmissions.org/blogs/entry/welcome_to_senior_haus_1,2674,0,0,0,0
Feb 15 2007,Cambridge,Sunny Skies In The OC,http://mitadmissions.org/blogs/entry/sunny_skies_in_the_oc,2674,0,0,0,0
Feb 15 2007,MISTI Program,MISTI-India: Community Health Internship,http://mitadmissions.org/blogs/entry/mistiindia_community_health_in,2674,0,0,0,0
Feb 15 2007,Matt McGann '00,New ZigZag video podcast & behind the scenes,http://mitadmissions.org/blogs/entry/new_zigzag_video_podcast_behin,2674,0,0,0,0
Feb 15 2007,Melis A. '08,Mad scientist?,http://mitadmissions.org/blogs/entry/mad_scientist,2674,0,0,0,0
Feb 14 2007,Laura N. '09,Rain is evil,http://mitadmissions.org/blogs/entry/rain_is_evil,2675,0,0,0,0
Feb 14 2007,Bryan O. '09,My Funny Valentine,http://mitadmissions.org/blogs/entry/my_funny_valentine,2675,0,0,0,0
Feb 14 2007,Mitra L. '07,Classes - Spring 07,http://mitadmissions.org/blogs/entry/classes_spring_07,2675,0,0,0,0
Feb 13 2007,Daniel Barkowitz,Some brief updates,http://mitadmissions.org/blogs/entry/some_brief_updates,2676,0,0,0,0
Feb 13 2007,Matt McGann '00,Show your creativity: the Year of the Pig,http://mitadmissions.org/blogs/entry/show_your_creativity_the_year,2676,0,0,0,0
Feb 11 2007,Jess K. '10,Questions Answered,http://mitadmissions.org/blogs/entry/questions_answered,2678,0,0,0,0
Feb 11 2007,Mitra L. '07,Follow Your Intuition,http://mitadmissions.org/blogs/entry/follow_your_intuition,2678,0,0,0,0
Feb 10 2007,Melis A. '08,Spreading yourself too thin,http://mitadmissions.org/blogs/entry/spreading_yourself_too_thin,2679,0,0,0,0
Feb 9 2007,Keri G. '10,Laundry Lists,http://mitadmissions.org/blogs/entry/oooh_moving,2680,0,0,0,0
Feb 8 2007,Ben Jones,A Chances Thread That Is Actually Worth Reading,http://mitadmissions.org/blogs/entry/a_chances_thread_that_is_actua,2681,0,0,0,0
Feb 8 2007,Bryan O. '09,"Retreat, RETREAT!!",http://mitadmissions.org/blogs/entry/retreat_retreat_1,2681,0,0,0,0
Feb 7 2007,Laura N. '09,By the numbers,http://mitadmissions.org/blogs/entry/by_the_numbers,2682,0,0,0,0
Feb 7 2007,Melis A. '08,Guest Blog: Kevins reflections after an IAP externship at a start-up company,http://mitadmissions.org/blogs/entry/guest_blog_kevins_reflections,2682,0,0,0,0
Feb 6 2007,Matt McGann '00,Guessing game results,http://mitadmissions.org/blogs/entry/guessing_game_results,2683,0,0,0,0
Feb 5 2007,Mitra L. '07,You Can Plan a Pretty Picnic,http://mitadmissions.org/blogs/entry/you_can_plan_a_pretty_picnic,2684,0,0,0,0
Feb 4 2007,Matt McGann '00,"Numbers, Perfect and Imperfect",http://mitadmissions.org/blogs/entry/numbers_perfect_and_imperfect,2685,0,0,0,0
Feb 3 2007,Jess K. '10,Next House Showers Bring No Flowers,http://mitadmissions.org/blogs/entry/next_house_showers_bring_no_fl,2686,0,0,0,0
Feb 1 2007,Jessie L. '07,More IAP updates,http://mitadmissions.org/blogs/entry/more_iap_updates,2688,0,0,0,0
Feb 1 2007,Laurie Everett,Narrative of Discovery,http://mitadmissions.org/blogs/entry/narrative_of_discovery,2688,0,0,0,0
Feb 1 2007,Bryan O. '09,squeeeeeeeeee!,http://mitadmissions.org/blogs/entry/squeeeeeeeeee,2688,0,0,0,0
Feb 1 2007,Anthony R. '09,MIT OpenLabWare: an interdisciplinary collaboration,http://mitadmissions.org/blogs/entry/mit_openlabware_an_interdiscip,2688,0,0,0,0
Jan 31 2007,Melis A. '08,MITHenge,http://mitadmissions.org/blogs/entry/mithenge,2689,0,2,0,2
Jan 30 2007,Lulu L. '09,A Look at Unified Engineering and the Aero/Astro Department,http://mitadmissions.org/blogs/entry/a_look_at_unified_engineering,2690,0,0,0,0
Jan 28 2007,Bryan O. '09,Little Snails,http://mitadmissions.org/blogs/entry/little_snails,2692,0,0,0,0
Jan 27 2007,Laura N. '09,Browser Wars,http://mitadmissions.org/blogs/entry/browser_wars,2693,0,0,0,0
Jan 26 2007,Keri G. '10,Then and Now,http://mitadmissions.org/blogs/entry/spring_term_schedules_are_up,2694,0,0,0,0
Jan 26 2007,Matt McGann '00,"Juniors: MITES, RSI and WTP deadlines approaching",http://mitadmissions.org/blogs/entry/juniors_mites_rsi_and_wtp_deadlines_approaching,2694,1,0,0,1
Jan 26 2007,Matt McGann '00,More HS Summer Programs,http://mitadmissions.org/blogs/entry/more_hs_summer_programs,2694,2,0,0,2
Jan 26 2007,Bryan O. '09,A Night with Cranium,http://mitadmissions.org/blogs/entry/a_night_with_cranium,2694,0,0,0,0
Jan 26 2007,Sam M. '07,For pi are cubed.,http://mitadmissions.org/blogs/entry/for_pi_are_cubed,2694,0,0,0,0
Jan 24 2007,Matt McGann '00,Missing Pieces,http://mitadmissions.org/blogs/entry/missing_pieces,2696,0,0,0,0
Jan 24 2007,Laurie Everett,Poetry and Physics,http://mitadmissions.org/blogs/entry/poetry_and_physics,2696,0,0,0,0
Jan 23 2007,Sam M. '07,I want you to burn,http://mitadmissions.org/blogs/entry/i_want_you_to_burn,2697,0,0,0,0
Jan 23 2007,Ben Jones,Where Have I Been?,http://mitadmissions.org/blogs/entry/where_have_i_been,2697,0,0,0,0
Jan 23 2007,Chancellor Eric Grimson,Professors Are Human Too (Really!),http://mitadmissions.org/blogs/entry/professors_are_human_too_reall,2697,0,0,0,0
Jan 23 2007,Cambridge,Some Perks Of Life At The Other Cambridge,http://mitadmissions.org/blogs/entry/some_perks_of_life_at_the_othe,2697,0,0,0,0
Jan 23 2007,Bryan G. Nance,"Ah, TV",http://mitadmissions.org/blogs/entry/ah_tv,2697,0,0,0,0
Jan 23 2007,Jess K. '10,OMG SNOW,http://mitadmissions.org/blogs/entry/omg_snow,2697,0,0,0,0
Jan 22 2007,Matt McGann '00,Tales from the application process,http://mitadmissions.org/blogs/entry/tales_from_the_application_pro,2698,0,0,0,0
Jan 21 2007,Melis A. '08,Combining the Arts and the Sciences,http://mitadmissions.org/blogs/entry/combining_the_arts_and_the_sci,2699,0,0,0,0
Jan 20 2007,Bryan O. '09,BEST WEEK OF 2007,http://mitadmissions.org/blogs/entry/best_week_of_2007,2700,0,0,0,0
Jan 19 2007,Jess K. '10,MIT Calling,http://mitadmissions.org/blogs/entry/youre_blogging_this_arent_you,2701,0,0,0,0
Jan 19 2007,Laura N. '09,"Take THAT, Microsoft",http://mitadmissions.org/blogs/entry/take_that_microsoft,2701,0,0,0,0
Jan 18 2007,Melis A. '08,Making house calls,http://mitadmissions.org/blogs/entry/making_house_calls,2702,0,0,0,0
Jan 18 2007,Matt McGann '00,Mid-January Updates,http://mitadmissions.org/blogs/entry/midjanuary_updates,2702,0,0,0,0
Jan 18 2007,Bryan G. Nance,What Is Your L?,http://mitadmissions.org/blogs/entry/what_is_your_l,2702,0,0,0,0
Jan 17 2007,Jess K. '10,IAP? No.. YOURE AP,http://mitadmissions.org/blogs/entry/iap_no_youre_ap_1,2703,0,0,0,0
Jan 17 2007,Keri G. '10,Wonder what an Amtrak station in the middle onowhere looks like?,http://mitadmissions.org/blogs/entry/wonder_what_an_amtrak_station_1,2703,0,0,0,0
Jan 16 2007,Matt McGann '00,Mystery Hunt 2007,http://mitadmissions.org/blogs/entry/mystery_hunt_2007,2704,0,0,0,0
Jan 15 2007,Bryan O. '09,"Puzzles, Puzzles, Puzzles",http://mitadmissions.org/blogs/entry/puzzles_puzzles_puzzles,2705,0,0,0,0
Jan 14 2007,Jessie L. '07,IAP is moving along,http://mitadmissions.org/blogs/entry/iap_is_moving_along,2706,0,0,0,0
Jan 14 2007,Bryan O. '09,The Coin Has Been Found!,http://mitadmissions.org/blogs/entry/the_coin_has_been_found,2706,0,0,0,0
Jan 14 2007,Sam M. '07,And I am telling you Im going,http://mitadmissions.org/blogs/entry/and_i_am_telling_you_im_going,2706,0,0,0,0
Jan 13 2007,Bryan O. '09,MYSTERY HUNT!,http://mitadmissions.org/blogs/entry/mystery_hunt,2707,0,0,0,0
Jan 12 2007,Matt McGann '00,Mystery Hunt Day 1,http://mitadmissions.org/blogs/entry/mystery_hunt_day_1,2708,0,0,0,0
Jan 11 2007,Mitra L. '07,Zambia Ate My Neighbors,http://mitadmissions.org/blogs/entry/zambia_ate_my_neighbors,2709,0,0,0,0
Jan 11 2007,Laurie Everett,Introduction To MIT World,http://mitadmissions.org/blogs/entry/introduction_to_mit_world,2709,0,0,0,0
Jan 10 2007,Sam M. '07,"Ina Garten Da Vida, Baby",http://mitadmissions.org/blogs/entry/ina_garten_da_vida_baby,2710,0,1,11,12
Jan 10 2007,Laura N. '09,Oh Sam,http://mitadmissions.org/blogs/entry/oh_sam,2710,0,0,0,0
Jan 10 2007,Matt McGann '00,Former MIT Students on TV,http://mitadmissions.org/blogs/entry/former_mit_students_on_tv,2710,0,0,0,0
Jan 10 2007,Mitra L. '07,"Im in Lusaka, baby, so why dont you blog me?",http://mitadmissions.org/blogs/entry/im_in_lusaka_baby_so_why_dont,2710,0,0,0,0
Jan 10 2007,Anthony R. '09,"An IAP in Texas, chapter two",http://mitadmissions.org/blogs/entry/an_iap_in_texas_chapter_two,2710,0,0,0,0
Jan 9 2007,Matt McGann '00,Random notes,http://mitadmissions.org/blogs/entry/random_notes_1,2711,0,0,0,0
Jan 9 2007,Melis A. '08,MIT  Problem Sets = IAP!,http://mitadmissions.org/blogs/entry/mit_problem_sets_iap,2711,0,0,0,0
Jan 8 2007,Matt McGann '00,IAP & Mystery Hunt preview,http://mitadmissions.org/blogs/entry/iap_mystery_hunt_preview,2712,0,0,0,0
Jan 7 2007,Bryan O. '09,"1 Month, 0 Classes",http://mitadmissions.org/blogs/entry/1_month_0_classes,2713,0,0,0,0
Jan 7 2007,Mitra L. '07,Off to Zambia,http://mitadmissions.org/blogs/entry/off_to_zambia,2713,0,0,0,0
Jan 6 2007,Laura N. '09,Q&A catchup,http://mitadmissions.org/blogs/entry/qa_catchup,2714,0,0,0,0
Jan 6 2007,Jess K. '10,Burn Out or Fade Away,http://mitadmissions.org/blogs/entry/burn_out_or_fade_away,2714,0,0,0,0
Jan 6 2007,Mitra L. '07,"Be Our Guest, Take 2",http://mitadmissions.org/blogs/entry/be_our_guest_take_2,2714,0,0,0,0
Jan 5 2007,Ben Jones,The Match,http://mitadmissions.org/blogs/entry/the_match,2715,0,0,0,0
Jan 4 2007,Matt McGann '00,Mini-contest: Your Application Reflections,http://mitadmissions.org/blogs/entry/minicontest_your_application_r,2716,0,0,0,0
Jan 3 2007,Laura N. '09,Funny pictures of me,http://mitadmissions.org/blogs/entry/funny_pictures_of_me,2717,0,0,0,0
Jan 3 2007,Daniel Barkowitz,The New Web Site is Live!!!,http://mitadmissions.org/blogs/entry/the_new_web_site_is_live,2717,0,0,0,0
Jan 2 2007,Melis A. '08,Happy New Year!,http://mitadmissions.org/blogs/entry/happy_new_year,2718,0,0,0,0
Jan 2 2007,Anthony R. '09,"An IAP in Texas, chapter one",http://mitadmissions.org/blogs/entry/an_iap_in_texas_chapter_one,2718,0,0,0,0
Dec 31 2006,Bryan O. '09,Deep Breaths,http://mitadmissions.org/blogs/entry/deep_breaths,2720,0,0,0,0
Dec 30 2006,Bryan O. '09,Home is where the heart (of Texas) is,http://mitadmissions.org/blogs/entry/home_is_where_the_heart_of_tex,2721,0,0,0,0
Dec 29 2006,Matt McGann '00,Deadline-time Questions Omnibus,http://mitadmissions.org/blogs/entry/deadlinetime_questions_omnibus,2722,0,0,0,0
Dec 27 2006,Matt McGann '00,"Holiday Gifts, MIT Style",http://mitadmissions.org/blogs/entry/holiday_gifts_mit_style,2724,0,0,0,0
Dec 27 2006,Laura N. '09,What the end of the semester does to Conner 2,http://mitadmissions.org/blogs/entry/what_the_end_of_the_semester_d,2724,0,0,0,0
Dec 26 2006,Sam M. '07,I Could Write a Song a Hundred Miles Long,http://mitadmissions.org/blogs/entry/i_could_write_a_song,2725,0,0,0,0
Dec 26 2006,Matt McGann '00,MIT Regular Action Deadline & Taking Questions,http://mitadmissions.org/blogs/entry/mit_regular_action_deadline_ta,2725,0,0,0,0
Dec 25 2006,Matt McGann '00,Twas the night before Christmas,http://mitadmissions.org/blogs/entry/twas_the_night_before_christma,2726,0,0,0,0
Dec 24 2006,Sam M. '07,"Nicht Bach, Sondern Maurer",http://mitadmissions.org/blogs/entry/nicht_bach,2727,0,0,0,0
Dec 24 2006,Keri G. '10,Adventures in Logan Airport,http://mitadmissions.org/blogs/entry/adventures_in_logan_airport,2727,0,0,0,0
Dec 23 2006,Jessie L. '07,Time and change,http://mitadmissions.org/blogs/entry/time_and_change,2728,0,0,0,0
Dec 22 2006,Sam M. '07,Soy Bomb,http://mitadmissions.org/blogs/entry/soy_bomb,2729,0,0,0,0
Dec 22 2006,Sam M. '07,The Promise of Ending,http://mitadmissions.org/blogs/entry/the_promise_of_ending_1,2729,0,0,0,0
Dec 22 2006,Jess K. '10,Back in Time,http://mitadmissions.org/blogs/entry/back_in_time,2729,0,0,0,0
Dec 21 2006,Bryan O. '09,Somewhat Random,http://mitadmissions.org/blogs/entry/somewhat_random,2730,0,0,0,0
Dec 21 2006,Ben Jones,Happy Holidays!,http://mitadmissions.org/blogs/entry/happy_holidays_1,2730,0,0,0,0
Dec 20 2006,Ben Jones,Answers To Your Questions Dec 2006,http://mitadmissions.org/blogs/entry/answers_to_your_questions_dec,2731,1,0,0,1
Dec 19 2006,Melis A. '08,NY Times article on women in science,http://mitadmissions.org/blogs/entry/ny_times_article_on_women_in_s,2732,0,0,0,0
Dec 19 2006,Bryan O. '09,Motivation,http://mitadmissions.org/blogs/entry/motivation,2732,0,0,0,0
Dec 19 2006,Matt McGann '00,New ZigZag and more,http://mitadmissions.org/blogs/entry/new_zigzag_and_more,2732,0,0,0,0
Dec 18 2006,Laura N. '09,Congratulations! You have been named,http://mitadmissions.org/blogs/entry/congratulations_you_have_been,2733,0,0,0,0
Dec 17 2006,Keri G. '10,Twas the night before the 8.01 final,http://mitadmissions.org/blogs/entry/twas_the_night_before_the_801,2734,0,0,0,0
Dec 17 2006,Bryan O. '09,21st Century Education?,http://mitadmissions.org/blogs/entry/21st_century_education,2734,0,0,0,0
Dec 15 2006,Laura N. '09,Blast from the Past,http://mitadmissions.org/blogs/entry/blast_from_the_past,2736,0,0,0,0
Dec 14 2006,Jessie L. '07,Worlds within worlds,http://mitadmissions.org/blogs/entry/worlds_within_worlds,2737,0,0,0,0
Dec 14 2006,Keri G. '10,Because one story just isnt enough,http://mitadmissions.org/blogs/entry/because_one_story_just_isnt_en,2737,0,0,0,0
Dec 13 2006,Jess K. '10,Even More for Admitted Students: Share Your Story,http://mitadmissions.org/blogs/entry/even_more_for_admitted_student,2738,0,0,0,0
Dec 12 2006,Bryan O. '09,Wheres Waldo?,http://mitadmissions.org/blogs/entry/wheres_waldo,2739,0,0,0,0
Dec 12 2006,Melis A. '08,Al Kwon 08: Researching drug delivery,http://mitadmissions.org/blogs/entry/al_kwon_08_researching_drug_de_1,2739,0,0,0,0
Dec 11 2006,Matt McGann '00,More For Deferred Students,http://mitadmissions.org/blogs/entry/more_for_deferred_students,2740,0,1,0,1
Dec 11 2006,Matt McGann '00,More For Admitted Students,http://mitadmissions.org/blogs/entry/more_for_admitted_students,2740,0,0,0,0
Dec 9 2006,Matt McGann '00,Early Action,http://mitadmissions.org/blogs/entry/early_action_1,2742,0,0,0,0
Dec 9 2006,Matt McGann '00,Open Thread: Admitted,http://mitadmissions.org/blogs/entry/open_thread_admitted,2742,0,0,0,0
Dec 9 2006,Matt McGann '00,Open Thread: Deferred,http://mitadmissions.org/blogs/entry/open_thread_deferred_1,2742,0,0,0,0
Dec 8 2006,Jess K. '10,Guest Entry: Christina Bognet,http://mitadmissions.org/blogs/entry/guest_entry,2743,1,2,1,4
Dec 7 2006,Melis A. '08,Candyland @ MIT,http://mitadmissions.org/blogs/entry/candyland_mit,2744,0,0,0,0
Dec 7 2006,Anthony R. '09,High Stakes,http://mitadmissions.org/blogs/entry/high_stakes,2744,0,0,0,0
Dec 6 2006,Lulu L. '09,A Peek at 8.033 - Relativity,http://mitadmissions.org/blogs/entry/a_peek_at_8033_relativity,2745,0,0,0,0
Dec 6 2006,Mitra L. '07,Be Our Guest,http://mitadmissions.org/blogs/entry/be_our_guest,2745,0,0,0,0
Dec 5 2006,Ben Jones,While You Wait,http://mitadmissions.org/blogs/entry/while_you_wait,2746,0,0,0,0
Dec 5 2006,Sam M. '07,Return of the Frog Queen,http://mitadmissions.org/blogs/entry/return_of_the,2746,0,0,0,0
Dec 5 2006,Melis A. '08,Admissions process reflections from a crusty Junior,http://mitadmissions.org/blogs/entry/admissions_process_reflections,2746,0,0,0,0
Dec 4 2006,Keri G. '10,We Brought Something?,http://mitadmissions.org/blogs/entry/we_brought_something,2747,0,0,0,0
Dec 4 2006,Jess K. '10,Were Bringing What Back?,http://mitadmissions.org/blogs/entry/were_bringing_what_back,2747,0,0,0,0
Dec 4 2006,Bryan O. '09,Were Bringing Snowflakes Back,http://mitadmissions.org/blogs/entry/were_bringing_snowflakes_back,2747,0,0,0,0
Dec 2 2006,Matt McGann '00,Update from selection,http://mitadmissions.org/blogs/entry/update_from_selection,2749,0,0,0,0
Dec 2 2006,Jess K. '10,Things to Do While Waiting for Decisions,http://mitadmissions.org/blogs/entry/things_to_do_while_waiting_for,2749,34,14,22,70
Dec 2 2006,Keri G. '10,"Children of Eden, seek for your garden.",http://mitadmissions.org/blogs/entry/ill_figure_this_one_out_soon_e,2749,0,0,0,0
Dec 2 2006,Laura N. '09,A Picture is Worth a Thousand Balloons,http://mitadmissions.org/blogs/entry/a_picture_is_worth_a_thousand,2749,0,0,0,0
Dec 1 2006,Ben Jones,If You Wish To Receive Your Decision Online,http://mitadmissions.org/blogs/entry/if_you_wish_to_receive_your_de,2750,0,0,0,0
Nov 29 2006,Bryan O. '09,Looking ahead to IAP,http://mitadmissions.org/blogs/entry/looking_ahead_to_iap_1,2752,0,0,0,0
Nov 28 2006,Melis A. '08,Spending the F.A.T. with Arthur Ganson,http://mitadmissions.org/blogs/entry/spending_the_fat_with_arthur_g,2753,0,0,0,0
Nov 28 2006,Mitra L. '07,Edmunds New Toy,http://mitadmissions.org/blogs/entry/edmunds_new_toy,2753,0,0,0,0
Nov 28 2006,Matt McGann '00,What should I be doing now?,http://mitadmissions.org/blogs/entry/what_should_i_be_doing_now,2753,1,0,0,1
Nov 27 2006,Keri G. '10,Weather Sensitive,http://mitadmissions.org/blogs/entry/weather_sensitive,2754,0,0,0,0
Nov 25 2006,Matt McGann '00,Video: Friendly Robots!,http://mitadmissions.org/blogs/entry/weekend_video_friendly_robots,2756,0,0,0,0
Nov 25 2006,Matt McGann '00,Video: New Zigzag,http://mitadmissions.org/blogs/entry/video_new_zigzag,2756,0,0,0,0
Nov 25 2006,Bryan O. '09,The Game,http://mitadmissions.org/blogs/entry/the_game,2756,0,0,0,0
Nov 24 2006,Lulu L. '09,Thanksgiving on First East - Team Bemis makes hand turkeys!!,http://mitadmissions.org/blogs/entry/thanksgiving_on_first_east_tea,2757,0,0,0,0
Nov 24 2006,Sam M. '07,You know my name,http://mitadmissions.org/blogs/entry/you_know_my_name,2757,0,0,0,0
Nov 23 2006,Matt McGann '00,Happy Thanksgiving!,http://mitadmissions.org/blogs/entry/happy_thanksgiving_2,2758,0,0,0,0
Nov 23 2006,Anthony R. '09,Spring Break and Study of Cities Abroad,http://mitadmissions.org/blogs/entry/spring_break_and_study_of_citi,2758,0,0,0,0
Nov 22 2006,Bryan G. Nance,A Cautionary Tale of Two Students,http://mitadmissions.org/blogs/entry/a_cautionary_tale_of_two_stude,2759,0,0,0,0
Nov 22 2006,Ben Jones,Answers To Your Questions,http://mitadmissions.org/blogs/entry/answers_to_your_questions,2759,0,0,0,0
Nov 22 2006,Matt McGann '00,The Case of the Disappearing Admissions Officers,http://mitadmissions.org/blogs/entry/the_case_of_the_disappearing_a,2759,0,0,0,0
Nov 20 2006,Melis A. '08,"Physical Education: because your body needs problem sets, too",http://mitadmissions.org/blogs/entry/physical_education_because_you,2761,0,0,0,0
Nov 19 2006,Bryan O. '09,Get Your Wii On.,http://mitadmissions.org/blogs/entry/get_your_wii_on,2762,0,0,0,0
Nov 18 2006,Jess K. '10,Conditioner For My Face,http://mitadmissions.org/blogs/entry/conditioner_for_my_face_1,2763,0,0,0,0
Nov 17 2006,Jessie L. '07,Admissions advice from someone whos been there,http://mitadmissions.org/blogs/entry/admissions_advice_from_someone,2764,18,4,2,24
Nov 16 2006,Bryan O. '09,A Tale of Two Majors,http://mitadmissions.org/blogs/entry/a_tale_of_two_majors,2765,0,0,0,0
Nov 16 2006,Lulu L. '09,"Sorry, no dorms yet but",http://mitadmissions.org/blogs/entry/sorry_no_dorms_yet_but,2765,0,0,0,0
Nov 16 2006,Mitra L. '07,Grind Time,http://mitadmissions.org/blogs/entry/grind_time,2765,0,0,0,0
Nov 15 2006,Anthony R. '09,A Bachelors & Masters in 5 Years,http://mitadmissions.org/blogs/entry/a_bachelors_masters_in_5_years,2766,0,0,0,0
Nov 14 2006,Melis A. '08,Think YOUR research is crazy?,http://mitadmissions.org/blogs/entry/think_your_research_is_crazy,2767,3,1,2,6
Nov 13 2006,Mitra L. '07,Senior Gift Kickoff,http://mitadmissions.org/blogs/entry/senior_gift_kickoff,2768,0,0,0,0
Nov 13 2006,Keri G. '10,"Summertime, and the livin is easy",http://mitadmissions.org/blogs/entry/summertime_and_the_livin_is_ea_1,2768,0,0,0,0
Nov 13 2006,Keri G. '10,Food? What?,http://mitadmissions.org/blogs/entry/food_what,2768,0,0,0,0
Nov 12 2006,Sam M. '07,Some Time in New York City,http://mitadmissions.org/blogs/entry/some_time_in,2769,0,0,0,0
Nov 12 2006,Jess K. '10,Writing Workshop,http://mitadmissions.org/blogs/entry/la_la_la,2769,0,0,0,0
Nov 12 2006,Melis A. '08,Exploring the newest innovations in dessert technology,http://mitadmissions.org/blogs/entry/exploring_the_newest_innovatio,2769,0,0,0,0
Nov 11 2006,Lulu L. '09,My night with 8.03,http://mitadmissions.org/blogs/entry/my_night_with_803,2770,1,1,0,2
Nov 10 2006,Sam M. '07,If man is five,http://mitadmissions.org/blogs/entry/if_man_is_five,2771,1,1,0,2
Nov 10 2006,Laura N. '09,Photographic evidence,http://mitadmissions.org/blogs/entry/photographic_evidence,2771,0,0,0,0
Nov 10 2006,Bryan O. '09,"Beat It, Bump It, Spike It",http://mitadmissions.org/blogs/entry/beat_it_bump_it_spike_it,2771,0,0,0,0
Nov 9 2006,Melis A. '08,Alia Whitney-Johnson: Making a Difference in Sri Lanka,http://mitadmissions.org/blogs/entry/alia_whitneyjohnson_making_a_d,2772,0,0,0,0
Nov 9 2006,Bryan O. '09,Take Your Blog to School Day Vol. 1,http://mitadmissions.org/blogs/entry/take_your_blog_to_school_day_v,2772,0,0,0,0
Nov 8 2006,Ben Jones,My First Full Reading Day,http://mitadmissions.org/blogs/entry/my_first_full_reading_day,2773,0,0,0,0
Nov 7 2006,Sam M. '07,Sorry 6.003,http://mitadmissions.org/blogs/entry/sorry_6003,2774,0,0,0,0
Nov 7 2006,Mitra L. '07,Are We Dating?,http://mitadmissions.org/blogs/entry/are_we_dating,2774,0,0,0,0
Nov 7 2006,Mitra L. '07,D-Lab Food Fest,http://mitadmissions.org/blogs/entry/dlab_food_fest,2774,0,0,0,0
Nov 7 2006,Laura N. '09,Delayed Reaction,http://mitadmissions.org/blogs/entry/delayed_reaction,2774,0,0,0,0
Nov 7 2006,Sam M. '07,The only living boy in New York,http://mitadmissions.org/blogs/entry/the_only_living_boy_in_new_yor,2774,0,0,0,0
Nov 6 2006,Melis A. '08,Everybody LOVES a math joke,http://mitadmissions.org/blogs/entry/everybody_loves_a_math_joke,2775,72,77,37,186
Nov 6 2006,Keri G. '10,Youve got questions,http://mitadmissions.org/blogs/entry/youve_got_questions,2775,0,0,0,0
Nov 5 2006,Jessie L. '07,For great justice,http://mitadmissions.org/blogs/entry/for_great_justice,2776,0,0,0,0
Nov 5 2006,Bryan O. '09,Who you gonna call?,http://mitadmissions.org/blogs/entry/who_you_gonna_call,2776,0,0,0,0
Nov 5 2006,Laura N. '09,Hey VMars fans,http://mitadmissions.org/blogs/entry/hey_vmars_fans,2776,0,0,0,0
Nov 5 2006,Anthony R. '09,Freshman Advisors Can Be Awesome,http://mitadmissions.org/blogs/entry/freshman_advisors_can_be_aweso,2776,0,0,0,0
Nov 4 2006,Jess K. '10,The Bicycle Diaries,http://mitadmissions.org/blogs/entry/the_bicycle_diaries,2777,0,0,0,0
Nov 3 2006,Melis A. '08,See your name among the stars,http://mitadmissions.org/blogs/entry/see_your_name_among_the_stars,2778,0,0,0,0
Nov 3 2006,Bryan O. '09,Reliving the good ol days,http://mitadmissions.org/blogs/entry/reliving_the_good_ol_days,2778,0,0,0,0
Nov 2 2006,Ben Jones,Long Overdue Q&A Post,http://mitadmissions.org/blogs/entry/long_overdue_qa_post,2779,0,0,0,0
Nov 1 2006,Sam M. '07,"Democrats, Republicans, sportsmanship, books",http://mitadmissions.org/blogs/entry/democrats_republicans_sportsma,2780,0,0,0,0
Nov 1 2006,Matt McGann '00,EA Deadline,http://mitadmissions.org/blogs/entry/ea_deadline,2780,0,0,0,0
Oct 31 2006,Mitra L. '07,Happy Halloween,http://mitadmissions.org/blogs/entry/happy_halloween,2781,0,0,0,0
Oct 31 2006,Stu Schmill '86,Having Trouble Reaching Your EC?,http://mitadmissions.org/blogs/entry/having_trouble_reaching_your_e,2781,0,0,0,0
Oct 30 2006,Stu Schmill '86,More On The Interview,http://mitadmissions.org/blogs/entry/more_on_the_interview_1,2782,0,0,0,0
Oct 30 2006,Matt McGann '00,Questions Omnibus & Fierce Forever,http://mitadmissions.org/blogs/entry/questions_omnibus_fierce_forev,2782,0,0,0,0
Oct 30 2006,Anthony R. '09,Cultura,http://mitadmissions.org/blogs/entry/cultura,2782,0,0,0,0
Oct 30 2006,Melis A. '08,Smashing pumpkins and other halloween treats,http://mitadmissions.org/blogs/entry/smashing_pumpkins_and_other_ha,2782,0,0,0,0
Oct 29 2006,Jessie L. '07,A week of work,http://mitadmissions.org/blogs/entry/a_week_of_work,2783,0,0,0,0
Oct 29 2006,Mitra L. '07,Marjane Satrapi and French Breakthroughs,http://mitadmissions.org/blogs/entry/marjane_satrapi_and_french_bre,2783,0,0,0,0
Oct 29 2006,Sam M. '07,Ice cream and an onion,http://mitadmissions.org/blogs/entry/ice_cream_and_an_onion,2783,0,0,0,0
Oct 28 2006,Keri G. '10,Breakfast with a Genius,http://mitadmissions.org/blogs/entry/breakfast_with_a_genius_1,2784,0,0,0,0
Oct 27 2006,Lulu L. '09,Making Things Fly,http://mitadmissions.org/blogs/entry/making_things_fly,2785,0,1,0,1
Oct 27 2006,Sam M. '07,Wolverine,http://mitadmissions.org/blogs/entry/wolverine,2785,0,0,0,0
Oct 27 2006,Matt McGann '00,"A Student, A Professor, An Alum",http://mitadmissions.org/blogs/entry/a_student_a_professor_an_alum,2785,0,0,0,0
Oct 26 2006,Melis A. '08,Halloween Preparations,http://mitadmissions.org/blogs/entry/halloween_preparations_1,2786,0,0,0,0
Oct 26 2006,Jess K. '10,How to Foil a UFO Abduction,http://mitadmissions.org/blogs/entry/how_to_foil_a_ufo_abduction,2786,0,0,0,0
Oct 26 2006,Mitra L. '07,Apple Sculptures,http://mitadmissions.org/blogs/entry/apple_sculptures,2786,0,0,0,0
Oct 24 2006,Matt McGann '00,On Supplemental Materials,http://mitadmissions.org/blogs/entry/on_supplemental_materials,2788,0,0,0,0
Oct 24 2006,Stu Schmill '86,More On The Interview,http://mitadmissions.org/blogs/entry/more_on_the_interview,2788,0,0,0,0
Oct 24 2006,mitblogs,A Day at the Beach: Quick Trips From MIT,http://mitadmissions.org/blogs/entry/a_day_at_the_beach_quick_trips,2788,0,0,0,0
Oct 23 2006,Bryan O. '09,Are you sure you dont want to cancel?,http://mitadmissions.org/blogs/entry/are_you_sure_you_dont_want_to,2789,0,0,0,0
Oct 23 2006,Lulu L. '09,"Hi, Im Lulu",http://mitadmissions.org/blogs/entry/hi_im_lulu,2789,0,0,0,0
Oct 23 2006,Keri G. '10,"Oh, sweet freedom?",http://mitadmissions.org/blogs/entry/oh_sweet_freedom_1,2789,0,0,0,0
Oct 23 2006,Matt McGann '00,October 06 Questions Omnibus,http://mitadmissions.org/blogs/entry/october_06_questions_omnibus,2789,0,0,0,0
Oct 22 2006,Sam M. '07,I like romantic things like music and art,http://mitadmissions.org/blogs/entry/i_like_romantic_things_like_mu,2790,0,0,0,0
Oct 22 2006,Jess K. '10,Im Kind of a Big Deal,http://mitadmissions.org/blogs/entry/im_kind_of_a_big_deal_1,2790,0,0,0,0
Oct 20 2006,Mitra L. '07,Paul Farmer at the Broad,http://mitadmissions.org/blogs/entry/paul_farmer_at_the_broad,2792,0,0,0,0
Oct 20 2006,Sam M. '07,This doesnt suck,http://mitadmissions.org/blogs/entry/this_doesnt_suck,2792,0,0,0,0
Oct 20 2006,Matt McGann '00,The Latest Updates,http://mitadmissions.org/blogs/entry/the_latest_updates,2792,0,0,0,0
Oct 20 2006,Laura N. '09,Application Advice v2.0,http://mitadmissions.org/blogs/entry/application_advice_v20,2792,0,0,0,0
Oct 19 2006,Ben Jones,MyMIT Status,http://mitadmissions.org/blogs/entry/mymit_status,2793,0,0,0,0
Oct 19 2006,Keri G. '10,"Hi, Im New Here",http://mitadmissions.org/blogs/entry/hi_im_new_here,2793,0,0,0,0
Oct 19 2006,John DeTore '80,Thoughts On The MIT Interview,http://mitadmissions.org/blogs/entry/thoughts_on_the_mit_interview,2793,6,7,0,13
Oct 19 2006,Ben Jones,Television Show Decisions,http://mitadmissions.org/blogs/entry/mymit_status_television_show_d,2793,0,0,0,0
Oct 18 2006,Bryan O. '09,Learn from my Mistake,http://mitadmissions.org/blogs/entry/learn_from_my_mistake,2794,0,0,0,0
Oct 18 2006,Anthony R. '09,Business As Usual,http://mitadmissions.org/blogs/entry/business_as_usual_1,2794,0,0,0,0
Oct 17 2006,Matt McGann '00,The Interview: 10/20 Approaches,http://mitadmissions.org/blogs/entry/the_interview_1020_approaches,2795,0,0,0,0
Oct 17 2006,Stu Schmill '86,A Typical Day on the Road,http://mitadmissions.org/blogs/entry/a_typical_day_on_the_road,2795,0,0,0,0
Oct 16 2006,Mitra L. '07,Meditation Mondays,http://mitadmissions.org/blogs/entry/meditation_mondays,2796,0,0,0,0
Oct 16 2006,Laura N. '09,The swing of things,http://mitadmissions.org/blogs/entry/the_swing_of_things,2796,0,0,0,0
Oct 16 2006,Jessie L. '07,"Past, present, and future",http://mitadmissions.org/blogs/entry/past_present_and_future,2796,0,0,0,0
Oct 15 2006,Jess K. '10,Leaf in Face,http://mitadmissions.org/blogs/entry/leaf_in_face_1,2797,0,0,0,0
Oct 14 2006,Matt McGann '00,On APs,http://mitadmissions.org/blogs/entry/on_aps_1,2798,4,3,1,8
Oct 14 2006,Sam M. '07,"O, GRE Battle",http://mitadmissions.org/blogs/entry/o_gre_battle,2798,0,0,0,0
Oct 12 2006,Sam M. '07,Colin Jackson is awesome,http://mitadmissions.org/blogs/entry/colin_jackson,2800,0,0,0,0
Oct 12 2006,Melis A. '08,No scissors allowed: OrigaMIT,http://mitadmissions.org/blogs/entry/no_scissors_allowed_origamit_1,2800,3,0,0,3
Oct 12 2006,Mitra L. '07,zOMG Zambia!,http://mitadmissions.org/blogs/entry/zomg_zambia,2800,0,0,0,0
Oct 12 2006,Matt McGann '00,Dean Marilee Jones in the news,http://mitadmissions.org/blogs/entry/dean_marilee_jones_in_the_news,2800,0,0,0,0
Oct 12 2006,Bryan O. '09,ADITL,http://mitadmissions.org/blogs/entry/aditl,2800,0,0,0,0
Oct 11 2006,Melis A. '08,Everything in moderationeven moderation.,http://mitadmissions.org/blogs/entry/everything_in_moderationeven_m,2801,0,0,0,0
Oct 11 2006,mitblogs,Food That Makes You Feel Like Home,http://mitadmissions.org/blogs/entry/food_that_makes_you_feel_like,2801,0,0,0,0
Oct 11 2006,Matt McGann '00,Build awesome,http://mitadmissions.org/blogs/entry/build_awesome_1,2801,0,0,0,0
Oct 10 2006,Jess K. '10,Reischauer Scholars Program,http://mitadmissions.org/blogs/entry/reischauer_scholars_program,2802,0,0,0,0
Oct 10 2006,Bryan O. '09,Youve got questions; Ive got (some) answers,http://mitadmissions.org/blogs/entry/youve_got_questions_ive_got_so,2802,0,0,0,0
Oct 9 2006,Anthony R. '09,Meow,http://mitadmissions.org/blogs/entry/meow,2803,0,0,0,0
Oct 8 2006,Matt McGann '00,Videos and photos and more,http://mitadmissions.org/blogs/entry/videos_and_photos_and_more,2804,0,0,0,0
Oct 8 2006,Bryan O. '09,You Gave Love A Bad Name,http://mitadmissions.org/blogs/entry/you_gave_love_a_bad_name,2804,0,0,0,0
Oct 7 2006,Laura N. '09,Questions and Answers,http://mitadmissions.org/blogs/entry/questions_and_answers_1,2805,0,0,0,0
Oct 6 2006,Sam M. '07,Like a freshman,http://mitadmissions.org/blogs/entry/like_a_freshman,2806,0,0,0,0
Oct 6 2006,Bryan O. '09,What do you want to know?,http://mitadmissions.org/blogs/entry/what_do_you_want_to_know,2806,1,0,0,1
Oct 5 2006,Sam M. '07,Pimp my sukkah.,http://mitadmissions.org/blogs/entry/pimp_my_sukkah,2807,0,0,0,0
Oct 5 2006,Laura N. '09,"MIT Nightlife, Part II",http://mitadmissions.org/blogs/entry/mit_nightlife_part_ii,2807,0,0,0,0
Oct 4 2006,Melis A. '08,The Nobel Connection,http://mitadmissions.org/blogs/entry/the_nobel_connection_1,2808,0,0,0,0
Oct 4 2006,Mitra L. '07,Hip-Pop - Konnecting Souls,http://mitadmissions.org/blogs/entry/post_6,2808,0,0,0,0
Oct 3 2006,Ben Jones,Fall Travel Recap; New Bloggers Announced,http://mitadmissions.org/blogs/entry/fall_travel_recap_new_bloggers,2809,0,0,0,0
Oct 3 2006,Matt McGann '00,Autumn Questions Omnibus,http://mitadmissions.org/blogs/entry/autumn_questions_omnibus,2809,0,0,0,0
Oct 2 2006,Jess K. '10,"Nuns, fret not!",http://mitadmissions.org/blogs/entry/nuns_fret_not,2810,0,0,0,0
Oct 2 2006,Mitra L. '07,Fuel from the Fields: MIT Charcoal Project,http://mitadmissions.org/blogs/entry/post_5,2810,1,1,0,2
Oct 2 2006,Sam M. '07,Freedom isnt free.,http://mitadmissions.org/blogs/entry/freedom_isnt_free,2810,0,0,0,0
Oct 1 2006,Bryan O. '09,Go Forth and Measure,http://mitadmissions.org/blogs/entry/go_forth_and_measure,2811,0,0,0,0
Oct 1 2006,Jessie L. '07,5E Rush Photos,http://mitadmissions.org/blogs/entry/5e_rush_photos,2811,0,0,0,0
Oct 1 2006,Jessie L. '07,East Campus Rush photos,http://mitadmissions.org/blogs/entry/east_campus_rush_photos,2811,0,0,0,0
Oct 1 2006,Sam M. '07,Its driving me nuts,http://mitadmissions.org/blogs/entry/its_driving_me_nuts,2811,0,0,0,0
Oct 1 2006,Melis A. '08,Retreat! Retreat!,http://mitadmissions.org/blogs/entry/retreat_retreat,2811,0,0,0,0
Sep 29 2006,Matt McGann '00,Rocky Mountain Round-Up,http://mitadmissions.org/blogs/entry/rocky_mountain_roundup,2813,0,0,0,0
Sep 29 2006,Bryan G. Nance,Tales From The Nance Effect Road Show,http://mitadmissions.org/blogs/entry/tales_from_the_nance_effect_ro,2813,0,0,0,0
Sep 27 2006,Sam M. '07,I need a fix cause Im goin down,http://mitadmissions.org/blogs/entry/i_need_a_fix_cause_im_goin_dow,2815,0,1,0,1
Sep 27 2006,Jess K. '10,Holiday,http://mitadmissions.org/blogs/entry/holiday,2815,0,0,0,0
Sep 27 2006,Mitra L. '07,Crazy Day,http://mitadmissions.org/blogs/entry/crazy_day_1,2815,0,0,0,0
Sep 26 2006,Daniel Barkowitz,Government Accountability Office (GAO) releases report on 568 Group,http://mitadmissions.org/blogs/entry/government_accountability_offi,2816,0,0,0,0
Sep 25 2006,Anthony R. '09,Taking Shape,http://mitadmissions.org/blogs/entry/taking_shape,2817,0,0,0,0
Sep 25 2006,Melis A. '08,The career fair and emerging pop stars,http://mitadmissions.org/blogs/entry/the_career_fair_and_emerging_p,2817,0,0,0,0
Sep 25 2006,Sam M. '07,Boys like cars and money,http://mitadmissions.org/blogs/entry/boys_like_cars_and_money,2817,0,0,0,0
Sep 24 2006,Bryan O. '09,A Reason to Celebrate,http://mitadmissions.org/blogs/entry/a_reason_to_celebrate,2818,0,0,0,0
Sep 24 2006,Jessie L. '07,Some summer pictures,http://mitadmissions.org/blogs/entry/some_summer_pictures,2818,0,0,0,0
Sep 23 2006,Bryan O. '09,Mnemonic Contest Winner,http://mitadmissions.org/blogs/entry/mnemonic_contest_winner,2819,0,0,0,0
Sep 22 2006,Jess K. '10,Testing the Waters,http://mitadmissions.org/blogs/entry/post_3,2820,0,0,0,0
Sep 22 2006,Daniel Barkowitz,"So, Enough About Early Admission, Lets Talk about Early Financial Aid",http://mitadmissions.org/blogs/entry/so_enough_about_early_admissio,2820,0,0,0,0
Sep 22 2006,Matt McGann '00,ZigZag 10,http://mitadmissions.org/blogs/entry/zigzag_10_1,2820,0,0,0,0
Sep 21 2006,Sam M. '07,Flavor of Love,http://mitadmissions.org/blogs/entry/flavor_of_love,2821,0,0,0,0
Sep 21 2006,Matt McGann '00,The Big MIT Career Fair,http://mitadmissions.org/blogs/entry/the_big_mit_career_fair,2821,0,0,0,0
Sep 21 2006,Laura N. '09,Amazin,http://mitadmissions.org/blogs/entry/amazin,2821,0,0,0,0
Sep 20 2006,Bryan O. '09,The Contest Continues,http://mitadmissions.org/blogs/entry/post_2,2822,0,0,0,0
Sep 19 2006,Sam M. '07,Born Under Punches,http://mitadmissions.org/blogs/entry/born_under_punches,2823,0,0,0,0
Sep 18 2006,Matt McGann '00,Marilee Jones in the news,http://mitadmissions.org/blogs/entry/marilee_jones_in_the_news_1,2824,0,1,0,1
Sep 18 2006,Daniel Barkowitz,Constitution Day (take two),http://mitadmissions.org/blogs/entry/constitution_day_take_two,2824,0,0,0,0
Sep 17 2006,Matt McGann '00,Bay Area wrap-up,http://mitadmissions.org/blogs/entry/bay_area_wrapup,2825,0,0,0,0
Sep 17 2006,Mitra L. '07,Stud/Fac Dinners,http://mitadmissions.org/blogs/entry/post,2825,0,0,0,0
Sep 17 2006,Laura N. '09,Pluto replies,http://mitadmissions.org/blogs/entry/pluto_replies,2825,0,0,0,0
Sep 17 2006,Mitra L. '07,Lit Analytics,http://mitadmissions.org/blogs/entry/lit_analytics,2825,0,0,0,0
Sep 17 2006,Bryan O. '09,Remember to Breathe,http://mitadmissions.org/blogs/entry/remember_to_breathe,2825,0,0,0,0
Sep 17 2006,Jess K. '10,Extracurricular Information,http://mitadmissions.org/blogs/entry/post_1,2825,1,0,0,1
Sep 16 2006,Melis A. '08,Prof. Manolis Kellis: Combining computer science with biology,http://mitadmissions.org/blogs/entry/prof_manolis_kellis_combining_1,2826,2,4,1,7
Sep 16 2006,Sam M. '07,It happens to Helen,http://mitadmissions.org/blogs/entry/it_happens_to_helen,2826,0,0,0,0
Sep 15 2006,Anthony R. '09,Stocking Up,http://mitadmissions.org/blogs/entry/stocking_up,2827,0,0,0,0
Sep 15 2006,Laura N. '09,"Theres antimony, arsenic, aluminum, selenium",http://mitadmissions.org/blogs/entry/theres_antimony_arsenic_alumin,2827,0,0,0,0
Sep 14 2006,Bryan O. '09,A Re-Introduction of Sorts,http://mitadmissions.org/blogs/entry/a_reintroduction_of_sorts,2828,0,0,0,0
Sep 14 2006,Daniel Barkowitz,Its Not Apparent Who is a Parent,http://mitadmissions.org/blogs/entry/its_not_apparent_who_is_a_pare,2828,0,0,0,0
Sep 14 2006,Ben Jones,The Birth Of My Third Child,http://mitadmissions.org/blogs/entry/the_birth_of_my_third_child,2828,0,0,0,0
Sep 12 2006,Sam M. '07,Someone saved my life tonight,http://mitadmissions.org/blogs/entry/someone_saved_my_life_tonight,2830,0,0,0,0
Sep 11 2006,Jess K. '10,Questions Omnibus,http://mitadmissions.org/blogs/entry/questions_omnibus,2831,0,0,0,0
Sep 11 2006,Jessie L. '07,As though we werent hosed enough,http://mitadmissions.org/blogs/entry/as_though_we_werent_hosed_enou,2831,0,0,0,0
Sep 10 2006,Matt McGann '00,Reno/Sacramento wrap-up,http://mitadmissions.org/blogs/entry/renosacramento_wrapup,2832,0,0,0,0
Sep 10 2006,Melis A. '08,Its that time of the year again,http://mitadmissions.org/blogs/entry/its_that_time_of_the_year_agai,2832,0,0,0,0
Sep 9 2006,Jessie L. '07,And term starts again,http://mitadmissions.org/blogs/entry/and_term_starts_again,2833,0,0,0,0
Sep 9 2006,Sam M. '07,I dont know where were going,http://mitadmissions.org/blogs/entry/i_dont_know_where_were_going,2833,0,0,0,0
Sep 9 2006,Jess K. '10,Friday,http://mitadmissions.org/blogs/entry/friday,2833,0,0,0,0
Sep 9 2006,Matt McGann '00,Hartford meeting wrap-up,http://mitadmissions.org/blogs/entry/hartford_meeting_wrapup,2833,0,0,0,0
Sep 8 2006,Mitra L. '07,Classes - Fall 06,http://mitadmissions.org/blogs/entry/classes_fall_06,2834,0,0,0,0
Sep 8 2006,Daniel Barkowitz,Come Play MIT-GO,http://mitadmissions.org/blogs/entry/come_play_mitgo,2834,0,0,0,0
Sep 7 2006,Bryan O. '09,Photo of the Day - Installment #1,http://mitadmissions.org/blogs/entry/photo_of_the_day_installment_1,2835,0,0,0,0
Sep 6 2006,Sam M. '07,The waking of all creatures that live on the land,http://mitadmissions.org/blogs/entry/the_waking_of_all_creatures_th,2836,0,0,0,0
Sep 6 2006,Daniel Barkowitz,Isaac Newtons Apple Tree Bears Fruit,http://mitadmissions.org/blogs/entry/isaac_newtons_apple_tree_bears,2836,0,0,0,0
Sep 6 2006,Melis A. '08,First day of school,http://mitadmissions.org/blogs/entry/first_day_of_school,2836,0,0,0,0
Sep 6 2006,Laura N. '09,Im Back!,http://mitadmissions.org/blogs/entry/im_back_1,2836,0,0,0,0
Sep 6 2006,Laura N. '09,Im Back!,http://mitadmissions.org/blogs/entry/im_back_11,2836,0,0,0,0
Sep 6 2006,Anthony R. '09,"Summer, East Campus rush, and the new term",http://mitadmissions.org/blogs/entry/summer_east_campus_rush_and_th,2836,0,1,0,1
Sep 5 2006,Daniel Barkowitz,A Financial Aid Director Reviews Accepted,http://mitadmissions.org/blogs/entry/a_financial_aid_director_revie,2837,0,0,0,0
Sep 5 2006,Matt McGann '00,Homeschooled applicants,http://mitadmissions.org/blogs/entry/homeschooled_applicants,2837,125,77,41,243
Sep 5 2006,Bryan G. Nance,Campus Visits Bring Em On!,http://mitadmissions.org/blogs/entry/campus_visits_bring_em_on,2837,0,0,0,0
Sep 4 2006,Mollie B. '06,"So long, farewell, auf wiedersehen, adieu",http://mitadmissions.org/blogs/entry/so_long_farewell_auf_wiederseh,2838,0,0,0,0
Sep 4 2006,Matt McGann '00,From Cambridge to You,http://mitadmissions.org/blogs/entry/from_cambridge_to_you,2838,0,0,0,0
Sep 4 2006,Ben Jones,RA Blogger Applications Due Wednesday 9/6 At Noon,http://mitadmissions.org/blogs/entry/ra_blogger_applications_due_we,2838,0,0,0,0
Sep 3 2006,Sam M. '07,When Im Home,http://mitadmissions.org/blogs/entry/when_im_home,2839,0,0,0,0
Sep 3 2006,Matt McGann '00,Two quick items from the web,http://mitadmissions.org/blogs/entry/two_quick_items_from_the_web,2839,0,0,0,0
Sep 3 2006,Mitra L. '07,Summer Programs For MIT Students,http://mitadmissions.org/blogs/entry/summer_programs,2839,0,0,0,0
Sep 3 2006,Jess K. '10,Passing Out,http://mitadmissions.org/blogs/entry/passing_out,2839,0,0,0,0
Sep 2 2006,Mollie B. '06,Two answers on a Saturday night,http://mitadmissions.org/blogs/entry/two_answers_on_a_saturday_nigh,2840,1,0,0,1
Sep 2 2006,Jess K. '10,FREE FOOD!,http://mitadmissions.org/blogs/entry/free_food_1,2840,0,0,0,0
Sep 2 2006,Bryan O. '09,Dont Dump,http://mitadmissions.org/blogs/entry/dont_dump,2840,0,0,0,0
Sep 1 2006,Jess K. '10,The Kim Affair,http://mitadmissions.org/blogs/entry/the_kim_affair,2841,0,0,0,0
Sep 1 2006,Melis A. '08,Heading back up,http://mitadmissions.org/blogs/entry/heading_back_up,2841,0,0,0,0
Aug 31 2006,Matt McGann '00,"Photo Contest, Round 2",http://mitadmissions.org/blogs/entry/photo_contest_round_2,2842,0,0,0,0
Aug 31 2006,Mollie B. '06,Public service announcement,http://mitadmissions.org/blogs/entry/public_service_announcement,2842,0,0,0,0
Aug 31 2006,Sam M. '07,And I realize Im going home,http://mitadmissions.org/blogs/entry/and_i_realize_im_going_home,2842,0,0,0,0
Aug 30 2006,Jess K. '10,"DME SoccerBot Championships 2006 (Or, How Does Justin Timberlake Live With Himself?)",http://mitadmissions.org/blogs/entry/dme_soccerbot_championships_20,2843,0,0,0,0
Aug 29 2006,Mitra L. '07,A Room with a Vieux,http://mitadmissions.org/blogs/entry/a_room_with_a_vieux,2844,0,0,0,0
Aug 29 2006,Matt McGann '00,ZigZag Episode 9,http://mitadmissions.org/blogs/entry/zigzag_episode_9,2844,0,0,0,0
Aug 29 2006,Melis A. '08,"Bermuda, Jaimaica, oooh I want to take you to",http://mitadmissions.org/blogs/entry/bermuda_jaimaica_oooh_i_want_t,2844,0,0,0,0
Aug 28 2006,Mollie B. '06,"Get psyched, stay with it, do whatever it takes",http://mitadmissions.org/blogs/entry/get_psyched_stay_with_it_do_wh,2845,0,0,0,0
Aug 28 2006,Sam M. '07,Everythings coming up Milhouse!,http://mitadmissions.org/blogs/entry/everythings_coming_up_milhouse,2845,0,0,0,0
Aug 27 2006,Matt McGann '00,MIT 10: Isaac Lozada,http://mitadmissions.org/blogs/entry/mit_10_isaac_lozada,2846,0,0,0,0
Aug 27 2006,Mitra L. '07,Back to Boston,http://mitadmissions.org/blogs/entry/back_to_boston,2846,0,0,0,0
Aug 25 2006,Matt McGann '00,"Photo Contest, Round 1",http://mitadmissions.org/blogs/entry/photo_contest_round_1,2848,0,0,0,0
Aug 25 2006,Mollie B. '06,Value added,http://mitadmissions.org/blogs/entry/value_added,2848,0,0,0,0
Aug 25 2006,Bryan O. '09,Redefinitions,http://mitadmissions.org/blogs/entry/redefinitions,2848,0,0,0,0
Aug 25 2006,Sam M. '07,The best picture we took in Paris,http://mitadmissions.org/blogs/entry/the_best_picture_we_took_in_pa,2848,0,0,0,0
Aug 24 2006,Matt McGann '00,Pre-Orientation Begins,http://mitadmissions.org/blogs/entry/preorientation_begins,2849,0,0,0,0
Aug 24 2006,Sam M. '07,"Come on, lets go food truckin",http://mitadmissions.org/blogs/entry/come_on_lets_go_food_truckin,2849,0,0,0,0
Aug 23 2006,Ben Jones,50 Things,http://mitadmissions.org/blogs/entry/50_things,2850,10486,5786,4728,21000
Aug 23 2006,Sam M. '07,I read the news today,http://mitadmissions.org/blogs/entry/i_read_the_news_today,2850,0,0,0,0
Aug 22 2006,Mollie B. '06,Home safe,http://mitadmissions.org/blogs/entry/home_safe,2851,0,0,0,0
Aug 22 2006,Bryan O. '09,A Sign of Things to Come,http://mitadmissions.org/blogs/entry/a_sign_of_things_to_come,2851,0,0,0,0
Aug 22 2006,Sam M. '07,The second-best picture we took in Paris,http://mitadmissions.org/blogs/entry/the_secondbest_picture_we_took,2851,0,0,0,0
Aug 21 2006,Jess K. '10,Time Difference,http://mitadmissions.org/blogs/entry/time_difference,2852,0,0,0,0
Aug 21 2006,Daniel Barkowitz,What I Did During My Lunch Hour - Part 1,http://mitadmissions.org/blogs/entry/what_i_did_during_my_lunch_hou,2852,0,0,0,0
Aug 21 2006,Sam M. '07,"Gee, my lifes a funny thing",http://mitadmissions.org/blogs/entry/gee_my_lifes_a_funny_thing,2852,1,0,0,1
Aug 20 2006,Matt McGann '00,Straight from the Deans mouth,http://mitadmissions.org/blogs/entry/straight_from_the_deans_mouth,2853,0,0,0,0
Aug 20 2006,Mitra L. '07,Biking the bridge,http://mitadmissions.org/blogs/entry/biking_the_bridge,2853,0,0,0,0
Aug 20 2006,Jess K. '10,Summer Lovin,http://mitadmissions.org/blogs/entry/summer_lovin,2853,0,0,0,0
Aug 20 2006,Mollie B. '06,My Brass Rat,http://mitadmissions.org/blogs/entry/my_brass_rat,2853,0,0,0,0
Aug 19 2006,Melis A. '08,Want a bike?,http://mitadmissions.org/blogs/entry/want_a_bike,2854,0,0,0,0
Aug 18 2006,Matt McGann '00,MIT Abounds With UROP Students,http://mitadmissions.org/blogs/entry/mit_abounds_with_urop_students,2855,0,0,0,0
Aug 18 2006,Sam M. '07,We open in Venice,http://mitadmissions.org/blogs/entry/we_open_in_venice,2855,0,0,0,0
Aug 17 2006,Ben Jones,A Preview Of My Summer Project,http://mitadmissions.org/blogs/entry/a_preview_of_my_summer_project,2856,0,0,0,0
Aug 17 2006,Bryan O. '09,MVEMJSUNP,http://mitadmissions.org/blogs/entry/mvemjsunp,2856,0,3,0,3
Aug 17 2006,Sam M. '07,"Where are you going, where have you been?",http://mitadmissions.org/blogs/entry/where_are_you_going_where_have,2856,0,0,0,0
Aug 16 2006,Bryan O. '09,I Love Math,http://mitadmissions.org/blogs/entry/i_love_math,2857,0,0,0,0
Aug 16 2006,Laura N. '09,A Quick Update,http://mitadmissions.org/blogs/entry/a_quick_update,2857,0,0,0,0
Aug 16 2006,Mollie B. '06,Felicitation,http://mitadmissions.org/blogs/entry/felicitation,2857,0,0,0,0
Aug 16 2006,Matt McGann '00,"Heidemarie Stefanyshyn-Piper 84, Astronaut",http://mitadmissions.org/blogs/entry/heidemarie_stefanyshynpiper_84,2857,0,0,0,0
Aug 16 2006,Anthony R. '09,A Half-Century of Hacking,http://mitadmissions.org/blogs/entry/a_halfcentury_of_hacking,2857,0,0,0,0
Aug 15 2006,Mollie B. '06,Solicitation,http://mitadmissions.org/blogs/entry/solicitation,2858,0,0,0,0
Aug 15 2006,Daniel Barkowitz,"Congratulations, youve just won $1,000,000",http://mitadmissions.org/blogs/entry/congratulations_youve_just_won,2858,0,0,0,0
Aug 15 2006,Melis A. '08,Who Needs Harvard?,http://mitadmissions.org/blogs/entry/who_needs_harvard,2858,0,1,0,1
Aug 14 2006,Jess K. '10,We Started the Fire,http://mitadmissions.org/blogs/entry/we_started_the_fire,2859,0,0,0,0
Aug 14 2006,Melis A. '08,Buying books,http://mitadmissions.org/blogs/entry/buying_books,2859,0,0,0,0
Aug 14 2006,Daniel Barkowitz,Of Crabs and Careers,http://mitadmissions.org/blogs/entry/of_crabs_and_careers,2859,0,0,0,0
Aug 14 2006,Bryan O. '09,A Man of Many Hat(ches),http://mitadmissions.org/blogs/entry/a_man_of_many_hatches,2859,0,0,0,0
Aug 13 2006,Matt McGann '00,"Radia Perlman 73, Mother of the Internet",http://mitadmissions.org/blogs/entry/radia_perlman_73_mother_of_the,2860,5,2,10,17
Aug 13 2006,Daniel Barkowitz,The Outside Award Reward,http://mitadmissions.org/blogs/entry/the_outside_award_reward,2860,0,0,0,0
Aug 13 2006,Jessie L. '07,Things you might have wanted to know,http://mitadmissions.org/blogs/entry/things_you_might_have_wanted_t,2860,0,0,0,0
Aug 13 2006,Mitra L. '07,You Are LUSCIOUS,http://mitadmissions.org/blogs/entry/you_are_luscious,2860,0,0,0,0
Aug 13 2006,Melis A. '08,Schedules and expectations,http://mitadmissions.org/blogs/entry/schedules_and_expectations,2860,0,0,0,0
Aug 12 2006,Mollie B. '06,First term freshman year,http://mitadmissions.org/blogs/entry/first_term_freshman_year,2861,0,2,0,2
Aug 12 2006,Matt McGann '00,From across the Web,http://mitadmissions.org/blogs/entry/from_across_the_web,2861,0,0,0,0
Aug 12 2006,Bryan O. '09,To BE or not to BE,http://mitadmissions.org/blogs/entry/to_be_or_not_to_be,2861,0,0,0,0
Aug 12 2006,Laura N. '09,The Rapids,http://mitadmissions.org/blogs/entry/the_rapids,2861,0,0,0,0
Aug 11 2006,Jess K. '10,Where is the banana,http://mitadmissions.org/blogs/entry/where_is_the_banana,2862,0,0,0,0
Aug 10 2006,Matt McGann '00,Omnibus Followup: Women in Engineering,http://mitadmissions.org/blogs/entry/omnibus_followup_women_in_engi,2863,0,0,0,0
Aug 10 2006,Sam M. '07,Turkey vs. Spam sells out,http://mitadmissions.org/blogs/entry/turkey_vs_spam_sells_out,2863,0,0,0,0
Aug 10 2006,Jessie L. '07,Meta,http://mitadmissions.org/blogs/entry/meta,2863,0,0,0,0
Aug 10 2006,Jess K. '10,Whos that new kid?,http://mitadmissions.org/blogs/entry/whos_that_new_kid,2863,0,0,0,0
Aug 9 2006,Laura N. '09,"Keep it simple, stupid",http://mitadmissions.org/blogs/entry/keep_it_simple_stupid,2864,0,0,0,0
Aug 9 2006,Ben Jones,Class of 2010: Wondering Where Everyone Is Living?,http://mitadmissions.org/blogs/entry/class_of_2010_wondering_where,2864,0,0,0,0
Aug 9 2006,Bryan G. Nance,Return of the Nance Effect,http://mitadmissions.org/blogs/entry/return_of_the_nance_effect,2864,0,0,0,0
Aug 9 2006,Mollie B. '06,The good advice,http://mitadmissions.org/blogs/entry/the_good_advice,2864,0,0,0,0
Aug 9 2006,Jessie L. '07,A quick plug,http://mitadmissions.org/blogs/entry/a_quick_plug,2864,0,0,0,0
Aug 9 2006,Sam M. '07,Swiss Miss,http://mitadmissions.org/blogs/entry/swiss_miss,2864,0,0,0,0
Aug 9 2006,Jessie L. '07,"Youve got questions, Ive got answers",http://mitadmissions.org/blogs/entry/youve_got_questions_ive_got_an,2864,0,0,0,0
Aug 8 2006,Matt McGann '00,August Questions Omnibus 1,http://mitadmissions.org/blogs/entry/august_questions_omnibus_1_1,2865,0,0,0,0
Aug 8 2006,Ben Jones,EA Blogger Application Decisions,http://mitadmissions.org/blogs/entry/ea_blogger_application_decisio,2865,0,0,0,0
Aug 7 2006,Daniel Barkowitz,Dont Miss-Pell,http://mitadmissions.org/blogs/entry/dont_misspell,2866,0,0,0,0
Aug 7 2006,Bryan O. '09,+1 for MIT,http://mitadmissions.org/blogs/entry/1_for_mit,2866,0,0,0,0
Aug 6 2006,Melis A. '08,The best Metro station ever,http://mitadmissions.org/blogs/entry/the_best_metro_station_ever,2867,0,0,0,0
Aug 5 2006,Mitra L. '07,Teatro ZinZanni,http://mitadmissions.org/blogs/entry/teatro_zinzanni,2868,0,0,0,0
Aug 5 2006,Matt McGann '00,MIT 10: Sulinya Ramanan,http://mitadmissions.org/blogs/entry/mit_10_sulinya_ramanan_1,2868,9,1,2,12
Aug 4 2006,Jessie L. '07,Pictures of me,http://mitadmissions.org/blogs/entry/pictures_of_me,2869,0,0,0,0
Aug 4 2006,Matt McGann '00,MIT 10: Molly Pounds,http://mitadmissions.org/blogs/entry/mit_10_molly_pounds_1,2869,0,0,0,0
Aug 4 2006,Sam M. '07,Ten Things I Hate About Europe,http://mitadmissions.org/blogs/entry/ten_things_i_hate_about_europe,2869,0,0,0,0
Aug 3 2006,Matt McGann '00,MIT 10: Quentin Smith,http://mitadmissions.org/blogs/entry/mit_10_quentin_smith_1,2870,0,0,0,0
Aug 3 2006,Sam M. '07,More entries about buildings and food,http://mitadmissions.org/blogs/entry/more_entries_about_buildings_a,2870,0,0,0,0
Aug 2 2006,Mollie B. '06,"Post-engagement, pre-Bahamas",http://mitadmissions.org/blogs/entry/postengagement_prebahamas,2871,0,0,0,0
Aug 2 2006,Daniel Barkowitz,FREE FOOD!!!,http://mitadmissions.org/blogs/entry/free_food,2871,0,0,0,0
Aug 2 2006,Matt McGann '00,MIT 10: Ervin Puskar,http://mitadmissions.org/blogs/entry/mit_10_ervin_puskar_1,2871,0,0,0,0
Aug 2 2006,Bryan O. '09,The Number Game,http://mitadmissions.org/blogs/entry/the_number_game,2871,0,0,0,0
Aug 2 2006,Melis A. '08,College must-haves,http://mitadmissions.org/blogs/entry/college_musthaves,2871,0,1,0,1
Aug 1 2006,Daniel Barkowitz,Happy 25th Birthday MTV!,http://mitadmissions.org/blogs/entry/happy_25th_birthday_mtv,2872,0,0,0,0
Aug 1 2006,Mollie B. '06,Double legacy,http://mitadmissions.org/blogs/entry/double_legacy,2872,0,0,0,0
Aug 1 2006,Matt McGann '00,MIT 10: Anthony Rindone,http://mitadmissions.org/blogs/entry/mit_10_anthony_rindone,2872,0,0,0,0
Aug 1 2006,Sam M. '07,Look as good you will not,http://mitadmissions.org/blogs/entry/look_as_good_you_will_not,2872,0,0,0,0
Jul 31 2006,Ben Jones,I Am Not As Lame As I Appear,http://mitadmissions.org/blogs/entry/i_am_not_as_lame_as_i_appear,2873,0,0,0,0
Jul 31 2006,Matt McGann '00,MIT 10: Cristen Chinea,http://mitadmissions.org/blogs/entry/mit_10_cristen_chinea,2873,0,0,0,0
Jul 30 2006,Mollie B. '06,"Round here we stay up very, very late",http://mitadmissions.org/blogs/entry/round_here_we_stay_up_very_ver,2874,0,0,0,0
Jul 30 2006,Matt McGann '00,MIT 10: Corey Kubber,http://mitadmissions.org/blogs/entry/mit_10_corey_kubber,2874,0,0,0,0
Jul 29 2006,Matt McGann '00,MIT 10: Daniel Guillen,http://mitadmissions.org/blogs/entry/mit_10_daniel_guillen,2875,0,0,0,0
Jul 28 2006,Matt McGann '00,MIT 10: Another Fab Four,http://mitadmissions.org/blogs/entry/mit_10_another_fab_four,2876,0,0,0,0
Jul 28 2006,Sam M. '07,"Building, building, building, building",http://mitadmissions.org/blogs/entry/building_building_building_bui,2876,0,0,0,0
Jul 27 2006,Daniel Barkowitz,Im All About the Thumpa Thumpa or Opening Pandoras Music Box,http://mitadmissions.org/blogs/entry/im_all_about_the_thumpa_thumpa,2877,0,0,0,0
Jul 27 2006,Daniel Barkowitz,The Mighty MITES Talk About the Myths and Realities of Financial Aid,http://mitadmissions.org/blogs/entry/the_mighty_mites_talk_about_th,2877,0,0,0,0
Jul 27 2006,Matt McGann '00,MIT 10: The Plano Four,http://mitadmissions.org/blogs/entry/mit_10_the_plano_four,2877,0,0,0,0
Jul 27 2006,Sam M. '07,Turkey vs. Spams Hair,http://mitadmissions.org/blogs/entry/turkey_vs_spams_hair,2877,0,0,0,0
Jul 27 2006,Bryan O. '09,I Wish I Was an Astronaut,http://mitadmissions.org/blogs/entry/i_wish_i_was_an_astronaut,2877,0,0,0,0
Jul 26 2006,Mollie B. '06,Re-introduction,http://mitadmissions.org/blogs/entry/reintroduction,2878,0,0,0,0
Jul 26 2006,Daniel Barkowitz,Were am I! Where are You? Weary are We!,http://mitadmissions.org/blogs/entry/were_am_i_where_are_you_weary,2878,0,0,0,0
Jul 26 2006,Matt McGann '00,MIT 10s in the news,http://mitadmissions.org/blogs/entry/mit_10s_in_the_news,2878,0,0,0,0
Jul 26 2006,Matt McGann '00,MIT 10: Eletha Flores,http://mitadmissions.org/blogs/entry/mit_10_eletha_flores,2878,0,0,0,0
Jul 26 2006,Sam M. '07,A Day at the Races,http://mitadmissions.org/blogs/entry/a_day_at_the_races,2878,1,0,0,1
Jul 25 2006,Daniel Barkowitz,Academic Competitiveness Grants and SMART Grants,http://mitadmissions.org/blogs/entry/academic_competitiveness_grant,2879,0,0,0,0
Jul 25 2006,Daniel Barkowitz,It was twenty years ago today Sgt. Pepper taught the band to play,http://mitadmissions.org/blogs/entry/it_was_twenty_years_ago_today,2879,0,0,0,0
Jul 24 2006,Matt McGann '00,Class of 2010 profile,http://mitadmissions.org/blogs/entry/class_of_2010_profile,2880,0,0,0,0
Jul 24 2006,Ben Jones,Howdy,http://mitadmissions.org/blogs/entry/howdy,2880,0,0,0,0
Jul 24 2006,Bryan O. '09,Hes Making A List and Checking It Twice,http://mitadmissions.org/blogs/entry/hes_making_a_list_and_checking,2880,0,0,0,0
Jul 23 2006,Bryan O. '09,Gotta Catch Em All!,http://mitadmissions.org/blogs/entry/gotta_catch_em_all,2881,0,0,0,0
Jul 23 2006,Sam M. '07,"The train in Spain is ungainly, take a plane",http://mitadmissions.org/blogs/entry/the_train_in_spain_is_ungainly,2881,0,0,0,0
Jul 22 2006,Mollie B. '06,Just some potpourri,http://mitadmissions.org/blogs/entry/just_some_potpourri,2882,0,1,0,1
Jul 22 2006,Melis A. '08,Summer reading: The Language of God,http://mitadmissions.org/blogs/entry/summer_reading_the_language_of,2882,0,0,0,0
Jul 20 2006,Sam M. '07,Its the terror of knowing,http://mitadmissions.org/blogs/entry/its_the_terror_of_knowing,2884,5,2,0,7
Jul 19 2006,Mollie B. '06,Once upon a time,http://mitadmissions.org/blogs/entry/once_upon_a_time,2885,0,0,0,0
Jul 19 2006,Melis A. '08,Wahoo! MIT takes over Doonesbury!,http://mitadmissions.org/blogs/entry/wahoo_mit_takes_over_doonesbur,2885,0,0,0,0
Jul 19 2006,Jessie L. '07,What can you do in four years?,http://mitadmissions.org/blogs/entry/what_can_you_do_in_four_years,2885,0,0,0,0
Jul 19 2006,Bryan O. '09,Uh Oh,http://mitadmissions.org/blogs/entry/uh_oh,2885,0,0,0,0
Jul 18 2006,Sam M. '07,And sometimes why?,http://mitadmissions.org/blogs/entry/and_sometimes_why,2886,0,0,0,0
Jul 18 2006,Anthony R. '09,"East Campus, Part Two",http://mitadmissions.org/blogs/entry/east_campus_part_two,2886,0,0,0,0
Jul 17 2006,Matt McGann '00,International conference followup,http://mitadmissions.org/blogs/entry/international_conference_follo,2887,0,0,0,0
Jul 17 2006,Mitra L. '07,SF AIDS Walk - Part II,http://mitadmissions.org/blogs/entry/sf_aids_walk_part_ii,2887,0,0,0,0
Jul 17 2006,Melis A. '08,"To stay at MIT over the summer, or to not stay at MIT over the summerthat is the question",http://mitadmissions.org/blogs/entry/to_stay_at_mit_over_the_summer,2887,0,0,0,0
Jul 16 2006,Laura N. '09,Rosalind Franklin and Kent State,http://mitadmissions.org/blogs/entry/rosalind_franklin_and_kent_sta,2888,0,0,0,0
Jul 16 2006,Bryan O. '09,A Case of the Saturdays,http://mitadmissions.org/blogs/entry/a_case_of_the_saturdays,2888,0,0,0,0
Jul 16 2006,Mollie B. '06,Standing out,http://mitadmissions.org/blogs/entry/standing_out,2888,0,0,0,0
Jul 15 2006,Sam M. '07,Lodger,http://mitadmissions.org/blogs/entry/lodger,2889,0,0,0,0
Jul 15 2006,Matt McGann '00,Summer restaurant recommendations,http://mitadmissions.org/blogs/entry/summer_restaurant_recommendati,2889,0,0,0,0
Jul 14 2006,Sam M. '07,Heroes,http://mitadmissions.org/blogs/entry/heroes,2890,0,0,0,0
Jul 13 2006,Melis A. '08,Finding a job at the National Institutes of Health,http://mitadmissions.org/blogs/entry/finding_a_job_at_the_national,2891,0,0,0,0
Jul 13 2006,Sam M. '07,Low,http://mitadmissions.org/blogs/entry/low,2891,0,0,0,0
Jul 12 2006,Laura N. '09,Bubbles and UROPs,http://mitadmissions.org/blogs/entry/bubbles_and_urops,2892,0,0,0,0
Jul 12 2006,Anthony R. '09,What makes me an MIT student?,http://mitadmissions.org/blogs/entry/what_makes_me_an_mit_student,2892,0,0,0,0
Jul 12 2006,Mollie B. '06,A slightly snarkier guide to visitors,http://mitadmissions.org/blogs/entry/a_slightly_snarkier_guide_to_v,2892,0,0,0,0
Jul 12 2006,Ben Jones,So You Wanna Be A Blogger?,http://mitadmissions.org/blogs/entry/so_you_wanna_be_a_blogger,2892,0,0,0,0
Jul 11 2006,Matt McGann '00,Visiting MIT & Boston colleges,http://mitadmissions.org/blogs/entry/visiting_mit_boston_colleges,2893,0,0,0,0
Jul 11 2006,Ben Jones,Your Profile On The Web: Can It Hurt You?,http://mitadmissions.org/blogs/entry/your_profile_on_the_web_can_it,2893,0,0,0,0
Jul 11 2006,Jessie L. '07,Making friends,http://mitadmissions.org/blogs/entry/making_friends,2893,0,0,0,0
Jul 11 2006,Mitra L. '07,AIDS Walk San Francisco,http://mitadmissions.org/blogs/entry/aids_walk_san_francisco,2893,0,0,0,0
Jul 11 2006,Sam M. '07,Wir fahren nach Berlin!,http://mitadmissions.org/blogs/entry/wir_fahren_nach_berlin,2893,0,0,0,0
Jul 10 2006,Bryan O. '09,The Ultimate Showdown,http://mitadmissions.org/blogs/entry/the_ultimate_showdown,2894,0,0,0,0
Jul 10 2006,Ben Jones,Back From Vacation,http://mitadmissions.org/blogs/entry/back_from_vacation_1,2894,0,0,0,0
Jul 10 2006,Matt McGann '00,World Cup Final in Boston,http://mitadmissions.org/blogs/entry/world_cup_final_in_boston,2894,0,0,0,0
Jul 10 2006,Mitra L. '07,World Cup Finals,http://mitadmissions.org/blogs/entry/world_cup_finals,2894,0,0,0,0
Jul 9 2006,Ben Jones,The LiveJournal Survey,http://mitadmissions.org/blogs/entry/the_livejournal_survey,2895,0,0,0,0
Jul 9 2006,Laura N. '09,The Unfolding of Language,http://mitadmissions.org/blogs/entry/the_unfolding_of_language,2895,0,0,0,0
Jul 8 2006,Mollie B. '06,Freedom costs a buck-oh-five,http://mitadmissions.org/blogs/entry/freedom_costs_a_buckohfive,2896,0,2,0,2
Jul 8 2006,Ben Jones,The MySpace Survey,http://mitadmissions.org/blogs/entry/the_myspace_survey,2896,0,0,0,0
Jul 7 2006,Laura N. '09,Ponderings of a lifeguard,http://mitadmissions.org/blogs/entry/ponderings_of_a_lifeguard,2897,0,0,0,0
Jul 7 2006,Bryan O. '09,July 4th Pictorial,http://mitadmissions.org/blogs/entry/july_4th_pictorial,2897,0,0,0,0
Jul 7 2006,Matt McGann '00,ZigZag Episode 8,http://mitadmissions.org/blogs/entry/zigzag_episode_8,2897,0,0,0,0
Jul 7 2006,Sam M. '07,"Bonn, Games, Bonn",http://mitadmissions.org/blogs/entry/bonn_games_bonn,2897,0,0,0,0
Jul 7 2006,Ben Jones,The Xanga Survey,http://mitadmissions.org/blogs/entry/the_xanga_survey,2897,0,0,0,0
Jul 6 2006,Mollie B. '06,"Yes, I am still alive",http://mitadmissions.org/blogs/entry/yes_i_am_still_alive,2898,0,0,0,0
Jul 6 2006,Matt McGann '00,July Questions Omnibus 1,http://mitadmissions.org/blogs/entry/july_questions_omnibus_1_1,2898,0,0,0,0
Jul 5 2006,Matt McGann '00,Crazy admissions stories,http://mitadmissions.org/blogs/entry/crazy_admissions_stories,2899,2,2,1,5
Jul 4 2006,Melis A. '08,Happy 4th of July!,http://mitadmissions.org/blogs/entry/happy_4th_of_july,2900,0,0,0,0
Jul 4 2006,Bryan O. '09,I saw fireworks from the freeway,http://mitadmissions.org/blogs/entry/i_saw_fireworks_from_the_freew,2900,0,0,0,0
Jul 4 2006,Sam M. '07,Antietam? I hardly knew him.,http://mitadmissions.org/blogs/entry/antietam_i_hardly_knew_him,2900,0,0,0,0
Jul 3 2006,Jessie L. '07,What do you want to hear about?,http://mitadmissions.org/blogs/entry/what_do_you_want_to_hear_about,2901,0,0,0,0
Jul 2 2006,Matt McGann '00,4th of July Celebrations,http://mitadmissions.org/blogs/entry/4th_of_july_celebrations,2902,0,0,0,0
Jul 2 2006,Bryan O. '09,Recipe for Fun,http://mitadmissions.org/blogs/entry/recipe_for_fun,2902,0,0,0,0
Jul 1 2006,Anthony R. '09,Useful items to bring for dorm room,http://mitadmissions.org/blogs/entry/useful_items_to_bring_for_dorm,2903,0,10,0,10
Jul 1 2006,Mollie B. '06,Cellular neurobiology,http://mitadmissions.org/blogs/entry/cellular_neurobiology,2903,0,0,0,0
Jun 30 2006,Sam M. '07,I jumped into the river,http://mitadmissions.org/blogs/entry/i_jumped_into_the_river,2904,0,0,0,0
Jun 29 2006,Matt McGann '00,2006 MIT Admissions Statistics,http://mitadmissions.org/blogs/entry/2006_mit_admissions_statistics,2905,0,0,0,0
Jun 29 2006,Sam M. '07,Bavarian Rhapsody,http://mitadmissions.org/blogs/entry/bavarian_rhapsody,2905,0,0,0,0
Jun 28 2006,Sam M. '07,Number Mnchners,http://mitadmissions.org/blogs/entry/number_mnchners,2906,0,0,0,0
Jun 27 2006,Mollie B. '06,Gimme a C!,http://mitadmissions.org/blogs/entry/gimme_a_c,2907,0,0,0,0
Jun 27 2006,Bryan O. '09,"May 4, 2007",http://mitadmissions.org/blogs/entry/may_4_2007,2907,0,0,0,0
Jun 26 2006,Anthony R. '09,"East Campus, Part One",http://mitadmissions.org/blogs/entry/east_campus_part_one,2908,1,0,0,1
Jun 25 2006,Bryan O. '09,"Call Me, Emeril",http://mitadmissions.org/blogs/entry/call_me_emeril,2909,0,0,0,0
Jun 25 2006,Melis A. '08,All About the MCATs,http://mitadmissions.org/blogs/entry/all_about_the_mcats,2909,0,0,0,0
Jun 24 2006,Mitra L. '07,Circus School,http://mitadmissions.org/blogs/entry/circus_school,2910,0,0,0,0
Jun 23 2006,Mollie B. '06,Neurony goodness,http://mitadmissions.org/blogs/entry/neurony_goodness,2911,0,0,0,0
Jun 23 2006,Sam M. '07,Like a Polaroid Picture,http://mitadmissions.org/blogs/entry/like_a_polaroid_picture,2911,0,0,0,0
Jun 23 2006,Jessie L. '07,Greetings from Switzerland,http://mitadmissions.org/blogs/entry/greetings_from_switzerland,2911,0,0,0,0
Jun 22 2006,Matt McGann '00,PrimeShooter,http://mitadmissions.org/blogs/entry/primeshooter,2912,0,0,0,0
Jun 21 2006,Anthony R. '09,Im not swollen anymore!,http://mitadmissions.org/blogs/entry/im_not_swollen_anymore,2913,0,0,0,0
Jun 20 2006,Mollie B. '06,She works hard for the money,http://mitadmissions.org/blogs/entry/she_works_hard_for_the_money,2914,0,0,0,0
Jun 20 2006,Matt McGann '00,Reality TV,http://mitadmissions.org/blogs/entry/reality_tv,2914,0,0,0,0
Jun 19 2006,Bryan O. '09,Accidents Happen,http://mitadmissions.org/blogs/entry/accidents_happen,2915,0,0,0,0
Jun 19 2006,Sam M. '07,Wouldnt it be Nice?,http://mitadmissions.org/blogs/entry/wouldnt_it_be_nice,2915,0,0,0,0
Jun 18 2006,Mollie B. '06,Perfect weekend,http://mitadmissions.org/blogs/entry/perfect_weekend,2916,0,0,0,0
Jun 18 2006,Laura N. '09,Where are you going with this?,http://mitadmissions.org/blogs/entry/where_are_you_going_with_this,2916,0,0,0,0
Jun 18 2006,Bryan O. '09,Q & A,http://mitadmissions.org/blogs/entry/q_a,2916,0,0,0,0
Jun 18 2006,Matt McGann '00,ZigZag Episode 7,http://mitadmissions.org/blogs/entry/zigzag_episode_7,2916,0,0,0,0
Jun 16 2006,Matt McGann '00,World Cup Challenge Results,http://mitadmissions.org/blogs/entry/world_cup_challenge_results,2918,0,0,0,0
Jun 15 2006,Ben Jones,Ecosystems And Web Sites,http://mitadmissions.org/blogs/entry/ecosystems_and_web_sites,2919,0,0,0,0
Jun 14 2006,Mollie B. '06,"Four years, four summers",http://mitadmissions.org/blogs/entry/four_years_four_summers,2920,0,0,0,0
Jun 14 2006,Bryan O. '09,"Toga, Toga, Toga",http://mitadmissions.org/blogs/entry/toga_toga_toga,2920,1,2,1,4
Jun 14 2006,Laura N. '09,Give the girl what she wants,http://mitadmissions.org/blogs/entry/give_the_girl_what_she_wants,2920,0,0,0,0
Jun 13 2006,Matt McGann '00,World Cup Challenge,http://mitadmissions.org/blogs/entry/world_cup_challenge,2921,0,0,0,0
Jun 13 2006,Mitra L. '07,MEng (Masters of Engineering),http://mitadmissions.org/blogs/entry/meng_masters_of_engineering,2921,0,0,0,0
Jun 12 2006,Bryan O. '09,Always A Toys R Us Kid,http://mitadmissions.org/blogs/entry/always_a_toys_r_us_kid,2922,0,0,0,0
Jun 12 2006,Matt McGann '00,MIT Reunion Weekend,http://mitadmissions.org/blogs/entry/mit_reunion_weekend,2922,0,0,0,0
Jun 12 2006,Sam M. '07,Last train to Koblenz,http://mitadmissions.org/blogs/entry/last_train_to_koblenz,2922,0,0,0,0
Jun 11 2006,Jessie L. '07,Summer plans,http://mitadmissions.org/blogs/entry/summer_plans,2923,0,0,0,0
Jun 9 2006,Mollie B. '06,"The sun comes up, then goes away",http://mitadmissions.org/blogs/entry/the_sun_comes_up_then_goes_awa,2925,0,0,0,0
Jun 9 2006,Mollie B. '06,Answering some questions,http://mitadmissions.org/blogs/entry/answering_some_questions,2925,0,0,0,0
Jun 9 2006,Matt McGann '00,MIT Graduation Webcast,http://mitadmissions.org/blogs/entry/mit_graduation_webcast,2925,0,0,0,0
Jun 9 2006,Matt McGann '00,Senior Week: Anjum Sharma,http://mitadmissions.org/blogs/entry/senior_week_anjum_sharma,2925,0,0,0,0
Jun 8 2006,Bryan G. Nance,The College Circle of Life,http://mitadmissions.org/blogs/entry/the_college_circle_of_life,2926,0,0,0,0
Jun 8 2006,Sam M. '07,DOMR,http://mitadmissions.org/blogs/entry/domr,2926,0,0,0,0
Jun 8 2006,Bryan O. '09,All Over Again,http://mitadmissions.org/blogs/entry/all_over_again,2926,0,0,0,0
Jun 7 2006,Melis A. '08,More about Residence Based Advising,http://mitadmissions.org/blogs/entry/more_about_residence_based_adv,2927,0,0,0,0
Jun 7 2006,Matt McGann '00,Scooper Bowl,http://mitadmissions.org/blogs/entry/scooper_bowl,2927,0,0,0,0
Jun 7 2006,Ben Jones,Thoughts On Global Leadership,http://mitadmissions.org/blogs/entry/thoughts_on_global_leadership,2927,0,0,0,0
Jun 7 2006,Mollie B. '06,An actual day in the lab,http://mitadmissions.org/blogs/entry/an_actual_day_in_the_lab,2927,4,2,4,10
Jun 6 2006,Sam M. '07,Hooked on a Feeling,http://mitadmissions.org/blogs/entry/hooked_on_a_feeling,2928,0,0,0,0
Jun 6 2006,Matt McGann '00,Idiots! MIT hacked the poll!,http://mitadmissions.org/blogs/entry/idiots_mit_hacked_the_poll,2928,0,0,0,0
Jun 5 2006,Melis A. '08,Back in MD,http://mitadmissions.org/blogs/entry/back_in_md,2929,0,0,0,0
Jun 5 2006,Matt McGann '00,Senior Week: Jonathan Lii,http://mitadmissions.org/blogs/entry/senior_week_jonathan_lii,2929,0,0,0,0
Jun 4 2006,Matt McGann '00,Senior Week: Mollie Burgoon,http://mitadmissions.org/blogs/entry/senior_week_mollie_burgoon,2930,0,0,0,0
Jun 4 2006,Matt McGann '00,Senior Week,http://mitadmissions.org/blogs/entry/senior_week,2930,0,0,0,0
Jun 4 2006,Mollie B. '06,Lazy hazy crazy,http://mitadmissions.org/blogs/entry/lazy_hazy_crazy,2930,0,0,0,0
Jun 4 2006,Jessie L. '07,A point to clarify,http://mitadmissions.org/blogs/entry/a_point_to_clarify,2930,0,0,0,0
Jun 3 2006,Bryan O. '09,Advising @ MIT,http://mitadmissions.org/blogs/entry/advising_mit,2931,0,0,0,0
Jun 2 2006,Jessie L. '07,Why does my kid have to move again?,http://mitadmissions.org/blogs/entry/why_does_my_kid_have_to_move_a,2932,0,0,0,0
Jun 1 2006,Mitra L. '07,Thanks,http://mitadmissions.org/blogs/entry/thanks_1,2933,0,0,0,0
Jun 1 2006,Matt McGann '00,ZigZag Episode 6,http://mitadmissions.org/blogs/entry/zigzag_episode_6,2933,0,0,0,0
Jun 1 2006,Ben Jones,A Morning With Sir Tim Berners-Lee,http://mitadmissions.org/blogs/entry/a_morning_with_sir_tim_berners,2933,0,0,0,0
Jun 1 2006,Sam M. '07,Piece of my Heart,http://mitadmissions.org/blogs/entry/piece_of_my_heart,2933,0,0,0,0
May 31 2006,Bryan O. '09,Vindicated!,http://mitadmissions.org/blogs/entry/vindicated,2934,0,0,0,0
May 31 2006,Matt McGann '00,End of May updates,http://mitadmissions.org/blogs/entry/end_of_may_updates,2934,0,0,0,0
May 30 2006,Mollie B. '06,Marking time,http://mitadmissions.org/blogs/entry/marking_time,2935,0,0,0,0
May 30 2006,Jessie L. '07,Update from Kentucky,http://mitadmissions.org/blogs/entry/update_from_kentucky,2935,0,0,0,0
May 29 2006,Sam M. '07,Far and Away,http://mitadmissions.org/blogs/entry/far_and_away,2936,0,0,0,0
May 28 2006,Bryan O. '09,Fear of Flying,http://mitadmissions.org/blogs/entry/fear_of_flying,2937,0,0,0,0
May 28 2006,Mitra L. '07,Scheduling Conflict,http://mitadmissions.org/blogs/entry/scheduling_conflict,2937,0,0,0,0
May 27 2006,Bryan O. '09,Roadtrip!,http://mitadmissions.org/blogs/entry/roadtrip,2938,0,0,0,0
May 27 2006,Sam M. '07,"In a little while, Ill be gone",http://mitadmissions.org/blogs/entry/in_a_little_while_ill_be_gone,2938,0,0,0,0
May 26 2006,Matt McGann '00,Doonesbury Conclusion,http://mitadmissions.org/blogs/entry/doonesbury_conclusion,2939,0,0,0,0
May 26 2006,Mollie B. '06,Next steps,http://mitadmissions.org/blogs/entry/next_steps,2939,0,0,0,0
May 26 2006,Ben Jones,Varsity Blogging,http://mitadmissions.org/blogs/entry/varsity_blogging,2939,0,0,0,0
May 25 2006,Matt McGann '00,Quick updates,http://mitadmissions.org/blogs/entry/quick_updates_1,2940,0,0,0,0
May 25 2006,Anthony R. '09,"May 25, 2006",http://mitadmissions.org/blogs/entry/may_25_2006,2940,0,0,0,0
May 23 2006,Laura N. '09,Catching up,http://mitadmissions.org/blogs/entry/catching_up,2942,1,0,0,1
May 23 2006,Melis A. '08,American Idol?,http://mitadmissions.org/blogs/entry/american_idol,2942,0,0,0,0
May 23 2006,Matt McGann '00,More Doonesbury,http://mitadmissions.org/blogs/entry/more_doonesbury,2942,0,0,0,0
May 23 2006,Ben Jones,"MIT 10s: Prom, Graduation, And Other End-Of-Year Photos",http://mitadmissions.org/blogs/entry/mit_10s_prom_graduation_and_ot,2942,1,0,0,1
May 23 2006,Mitra L. '07,Nike+iPod,http://mitadmissions.org/blogs/entry/nikeipod,2942,0,0,0,0
May 23 2006,Mollie B. '06,Who we are,http://mitadmissions.org/blogs/entry/who_we_are,2942,0,0,0,0
May 22 2006,Matt McGann '00,An Entrepreneurs Story,http://mitadmissions.org/blogs/entry/an_entrepreneurs_story,2943,0,0,0,0
May 21 2006,Sam M. '07,#9 Dream,http://mitadmissions.org/blogs/entry/9_dream,2944,0,0,0,0
May 21 2006,Anthony R. '09,nothing special,http://mitadmissions.org/blogs/entry/nothing_special,2944,0,0,0,0
May 21 2006,Mollie B. '06,"Productive, yes. Appropriately productive, no.",http://mitadmissions.org/blogs/entry/productive_yes_appropriately_p,2944,0,0,0,0
May 20 2006,Bryan O. '09,Finals!,http://mitadmissions.org/blogs/entry/finals,2945,0,0,0,0
May 20 2006,Matt McGann '00,ZigZag Episode 5,http://mitadmissions.org/blogs/entry/zigzag_episode_5,2945,0,0,0,0
May 19 2006,Jessie L. '07,"A speech, of sorts",http://mitadmissions.org/blogs/entry/a_speech_of_sorts,2946,0,0,0,0
May 19 2006,Anthony R. '09,Mid-May Update,http://mitadmissions.org/blogs/entry/midmay_update,2946,0,1,0,1
May 19 2006,Bryan O. '09,Fitting In,http://mitadmissions.org/blogs/entry/fitting_in,2946,0,0,0,0
May 19 2006,Ben Jones,An American Idol Math Question,http://mitadmissions.org/blogs/entry/an_american_idol_math_question,2946,0,1,2,3
May 18 2006,Matt McGann '00,Surprising Research Results,http://mitadmissions.org/blogs/entry/surprising_research_results,2947,0,0,0,0
May 18 2006,Ben Jones,Excitement On The Road,http://mitadmissions.org/blogs/entry/excitement_on_the_road,2947,0,0,0,0
May 18 2006,Melis A. '08,2.007: Where even your smallest part matters,http://mitadmissions.org/blogs/entry/2007_where_even_your_smallest,2947,0,0,0,0
May 17 2006,Mollie B. '06,"No more school, no more books",http://mitadmissions.org/blogs/entry/no_more_school_no_more_books,2948,0,0,0,0
May 17 2006,Sam M. '07,Aquatarkus,http://mitadmissions.org/blogs/entry/aquatarkus,2948,0,0,0,0
May 17 2006,Matt McGann '00,Yet Another MIT 2010?,http://mitadmissions.org/blogs/entry/yet_another_mit_2010,2948,0,0,0,0
May 17 2006,Bryan O. '09,2.007 play by play,http://mitadmissions.org/blogs/entry/2007_play_by_play,2948,0,0,0,0
May 16 2006,Sam M. '07,Cancel all operations,http://mitadmissions.org/blogs/entry/cancel_all_operations,2949,0,0,0,0
May 16 2006,Ben Jones,Admitted From The Waitlist?,http://mitadmissions.org/blogs/entry/admitted_from_the_waitlist,2949,0,0,0,0
May 15 2006,Melis A. '08,2.007 Competition Tomorrow,http://mitadmissions.org/blogs/entry/2007_competition_tomorrow,2950,0,0,0,0
May 15 2006,Matt McGann '00,Activate Party Mode!,http://mitadmissions.org/blogs/entry/activate_party_mode,2950,0,0,0,0
May 15 2006,Mitra L. '07,Boston Pops,http://mitadmissions.org/blogs/entry/boston_pops,2950,0,0,0,0
May 15 2006,Jessie L. '07,Adventures in Camberville,http://mitadmissions.org/blogs/entry/adventures_in_camberville,2950,0,0,0,0
May 14 2006,Mollie B. '06,"Activities, humanities, question-ities",http://mitadmissions.org/blogs/entry/activities_humanities_question,2951,0,0,0,0
May 14 2006,Matt McGann '00,ISEF Review,http://mitadmissions.org/blogs/entry/isef_review,2951,0,0,0,0
May 14 2006,Laura N. '09,MIT Dorms: Burton Conner House,http://mitadmissions.org/blogs/entry/mit_dorms_burton_conner_house,2951,0,2,0,2
May 14 2006,Bryan O. '09,MIT Dorms: Baker House,http://mitadmissions.org/blogs/entry/mit_dorms_baker_house,2951,1,0,0,1
May 13 2006,Mitra L. '07,The Suite Life,http://mitadmissions.org/blogs/entry/the_suite_life,2952,0,0,0,0
May 13 2006,Sam M. '07,MIT Dorms: Really Random,http://mitadmissions.org/blogs/entry/mit_dorms_really_random,2952,0,0,0,0
May 13 2006,Melis A. '08,Next House: Where The Sidewalk Ends,http://mitadmissions.org/blogs/entry/next_house_where_the_sidewalk,2952,0,2,0,2
May 12 2006,Ben Jones,Brain Dump,http://mitadmissions.org/blogs/entry/brain_dump,2953,0,0,0,0
May 12 2006,Matt McGann '00,Mind the Gap (again),http://mitadmissions.org/blogs/entry/mind_the_gap_again,2953,0,0,0,0
May 11 2006,Mollie B. '06,Surviving,http://mitadmissions.org/blogs/entry/surviving,2954,0,2,0,2
May 11 2006,Sam M. '07,"Play it again, Sam",http://mitadmissions.org/blogs/entry/play_it_again_sam,2954,0,0,0,0
May 10 2006,Anthony R. '09,That Lovely Pre-Finals Period,http://mitadmissions.org/blogs/entry/that_lovely_prefinals_period,2955,0,0,0,0
May 10 2006,Mitra L. '07,Dewey Love Libraries?,http://mitadmissions.org/blogs/entry/dewey_love_libraries,2955,0,0,0,0
May 9 2006,Bryan O. '09,Its alive!,http://mitadmissions.org/blogs/entry/its_alive,2956,0,0,0,0
May 9 2006,Mollie B. '06,Lots of questions today!,http://mitadmissions.org/blogs/entry/lots_of_questions_today,2956,0,0,0,0
May 9 2006,Ben Jones,"Waitlist, Etc.",http://mitadmissions.org/blogs/entry/waitlist_etc,2956,0,0,0,0
May 9 2006,Matt McGann '00,Waitlist,http://mitadmissions.org/blogs/entry/waitlist_1,2956,0,0,0,0
May 8 2006,Sam M. '07,Dass ein Ende mit mir haben muss,http://mitadmissions.org/blogs/entry/dass_ein_ende_mit_mir_haben_mu,2957,0,0,0,0
May 8 2006,Bryan G. Nance,Is It Possible To Respect A Racist Film?,http://mitadmissions.org/blogs/entry/is_it_possible_to_respect_a_ra,2957,0,0,0,0
May 7 2006,Melis A. '08,"Cake Concert, Wing Dinner, and Senior Ball",http://mitadmissions.org/blogs/entry/cake_concert_wing_dinner_and_s,2958,0,0,0,0
May 6 2006,Mollie B. '06,You gotta have stuff,http://mitadmissions.org/blogs/entry/you_gotta_have_stuff,2959,0,0,0,0
May 6 2006,Matt McGann '00,"He Zigs, He Zags",http://mitadmissions.org/blogs/entry/he_zigs_he_zags,2959,0,0,0,0
May 6 2006,Mitra L. '07,Lip Sync & Toons,http://mitadmissions.org/blogs/entry/lip_sync_toons,2959,0,0,0,0
May 5 2006,Matt McGann '00,Next Big Mailing is out,http://mitadmissions.org/blogs/entry/next_big_mailing_is_out,2960,0,0,0,0
May 5 2006,Sam M. '07,Let It Bleed,http://mitadmissions.org/blogs/entry/let_it_bleed,2960,0,1,0,1
May 4 2006,Matt McGann '00,Quick updates,http://mitadmissions.org/blogs/entry/quick_updates,2961,0,0,0,0
May 4 2006,Ben Jones,The Night I Shared A Stage With Marilee,http://mitadmissions.org/blogs/entry/the_night_i_shared_a_stage_wit,2961,0,0,0,0
May 4 2006,Sam M. '07,Bicycle Race,http://mitadmissions.org/blogs/entry/bicycle_race,2961,0,0,0,0
May 3 2006,Matt McGann '00,MIT ISEF Reception,http://mitadmissions.org/blogs/entry/mit_isef_reception,2962,0,0,0,0
May 3 2006,Mitra L. '07,Energy Forum,http://mitadmissions.org/blogs/entry/energy_forum,2962,0,0,0,0
May 2 2006,Mollie B. '06,Senioritis,http://mitadmissions.org/blogs/entry/senioritis,2963,0,0,0,0
May 1 2006,Sam M. '07,Dancing Days,http://mitadmissions.org/blogs/entry/dancing_days,2964,0,0,0,0
May 1 2006,Matt McGann '00,Class of 2010 Roll Call,http://mitadmissions.org/blogs/entry/class_of_2010_roll_call,2964,0,0,0,0
May 1 2006,Matt McGann '00,"Goodbye, Hope to See You Again",http://mitadmissions.org/blogs/entry/goodbye_hope_to_see_you_again,2964,0,0,0,0
Apr 30 2006,Sam M. '07,The Song Remains The Same,http://mitadmissions.org/blogs/entry/the_song_remains_the_same,2965,0,0,0,0
Apr 30 2006,Anthony R. '09,Making Tracks,http://mitadmissions.org/blogs/entry/making_tracks,2965,0,0,0,0
Apr 30 2006,Matt McGann '00,The Undecideds VII: Decided?,http://mitadmissions.org/blogs/entry/the_undecideds_vii_decided,2965,0,0,0,0
Apr 29 2006,Mollie B. '06,The root of all evil,http://mitadmissions.org/blogs/entry/the_root_of_all_evil,2966,0,0,0,0
Apr 29 2006,Melis A. '08,Come to AXO Lip Sync!,http://mitadmissions.org/blogs/entry/come_to_axo_lip_sync,2966,0,0,0,0
Apr 28 2006,Matt McGann '00,Have Your Cake & Drop Date Too,http://mitadmissions.org/blogs/entry/have_your_cake_drop_date_too,2967,0,0,0,0
Apr 28 2006,Melis A. '08,Making your college decision,http://mitadmissions.org/blogs/entry/making_your_college_decision,2967,0,0,0,0
Apr 27 2006,Sam M. '07,Springtime for Interns in Germany,http://mitadmissions.org/blogs/entry/springtime_for_interns_in_germ,2968,0,0,0,0
Apr 27 2006,Matt McGann '00,The Undecideds VI: The Undiscovered Country,http://mitadmissions.org/blogs/entry/the_undecideds_vi_the_undiscov,2968,0,0,0,0
Apr 27 2006,Mitra L. '07,Thursday,http://mitadmissions.org/blogs/entry/thursday,2968,0,0,0,0
Apr 26 2006,Mollie B. '06,DNA-mazing,http://mitadmissions.org/blogs/entry/dnamazing,2969,0,0,0,0
Apr 26 2006,Jessie L. '07,Neuroscience classes,http://mitadmissions.org/blogs/entry/neuroscience_classes,2969,0,0,0,0
Apr 26 2006,Ben Jones,Dating At MIT: Episode 1,http://mitadmissions.org/blogs/entry/dating_at_mit_episode_1,2969,0,0,0,0
Apr 25 2006,Bryan G. Nance,Nance Nance Revolution! (+ My CPW Recap),http://mitadmissions.org/blogs/entry/nance_nance_revolution_my_cpw,2970,0,0,0,0
Apr 25 2006,Matt McGann '00,The Undecideds and the Order of the Phoenix,http://mitadmissions.org/blogs/entry/the_undecideds_and_the_order_o,2970,0,0,0,0
Apr 24 2006,Sam M. '07,"Go, ninja, go.",http://mitadmissions.org/blogs/entry/go_ninja_go,2971,0,0,0,0
Apr 24 2006,mitblogs,Additional Questions & Answers Regarding Music At MIT,http://mitadmissions.org/blogs/entry/additional_questions_answers_r,2971,0,0,0,0
Apr 23 2006,Bryan O. '09,Whirlwind Weekend,http://mitadmissions.org/blogs/entry/whirlwind_weekend,2972,0,0,0,0
Apr 23 2006,Matt McGann '00,"The Undecideds, Episode 4: A New Hope",http://mitadmissions.org/blogs/entry/the_undecideds_episode_4_a_new,2972,0,0,0,0
Apr 23 2006,Laura N. '09,Collective Apprehension,http://mitadmissions.org/blogs/entry/collective_apprehension,2972,0,0,0,0
Apr 23 2006,Melis A. '08,Ring delivery!,http://mitadmissions.org/blogs/entry/ring_delivery,2972,0,0,0,0
Apr 23 2006,Mitra L. '07,Tech Nomads,http://mitadmissions.org/blogs/entry/tech_nomads,2972,0,0,0,0
Apr 22 2006,Mollie B. '06,You oughta know,http://mitadmissions.org/blogs/entry/you_oughta_know,2973,0,0,0,0
Apr 22 2006,Matt McGann '00,"The Undecideds, Part 3",http://mitadmissions.org/blogs/entry/the_undecideds_part_3,2973,0,0,0,0
Apr 22 2006,Jessie L. '07,This was meant to be written a week and a half ago,http://mitadmissions.org/blogs/entry/this_was_meant_to_be_written_a,2973,0,0,0,0
Apr 21 2006,Ben Jones,My Long-Overdue CPW Recap,http://mitadmissions.org/blogs/entry/my_longoverdue_cpw_recap,2974,0,0,0,0
Apr 21 2006,Matt McGann '00,"The Undecideds, Part 2",http://mitadmissions.org/blogs/entry/the_undecideds_part_2,2974,0,0,0,0
Apr 21 2006,Sam M. '07,Almost Famous,http://mitadmissions.org/blogs/entry/almost_famous,2974,0,0,0,0
Apr 20 2006,Anthony R. '09,Advising and freshman formalities,http://mitadmissions.org/blogs/entry/advising_and_freshman_formalit,2975,0,0,0,0
Apr 20 2006,Mollie B. '06,MIT Dorms: MacGregor House,http://mitadmissions.org/blogs/entry/mit_dorms_macgregor_house,2975,0,6,0,6
Apr 20 2006,Matt McGann '00,The Undecideds,http://mitadmissions.org/blogs/entry/the_undecideds,2975,0,0,0,0
Apr 19 2006,Melis A. '08,So you think you want to be a doctor: Pre-med at MIT,http://mitadmissions.org/blogs/entry/so_you_think_you_want_to_be_a,2976,0,2,0,2
Apr 19 2006,Bryan O. '09,I Tried to Ford the River,http://mitadmissions.org/blogs/entry/i_tried_to_ford_the_river,2976,0,0,0,0
Apr 18 2006,Matt McGann '00,April Questions Omnibus 1,http://mitadmissions.org/blogs/entry/april_questions_omnibus_1_1,2977,0,0,0,0
Apr 18 2006,Laura N. '09,Psets from hell,http://mitadmissions.org/blogs/entry/psets_from_hell,2977,0,0,0,0
Apr 18 2006,Ben Jones,Back From Vacation,http://mitadmissions.org/blogs/entry/back_from_vacation,2977,0,0,0,0
Apr 17 2006,Mollie B. '06,Practical virology,http://mitadmissions.org/blogs/entry/practical_virology,2978,0,0,0,0
Apr 17 2006,Sam M. '07,Dont stop me now!,http://mitadmissions.org/blogs/entry/dont_stop_me_now,2978,0,0,0,0
Apr 16 2006,Matt McGann '00,Get Animated,http://mitadmissions.org/blogs/entry/get_animated,2979,0,0,0,0
Apr 15 2006,Mitra L. '07,Sneak Preview,http://mitadmissions.org/blogs/entry/sneak_preview,2980,0,0,0,0
Apr 15 2006,Mollie B. '06,Home on the range,http://mitadmissions.org/blogs/entry/home_on_the_range,2980,0,0,0,0
Apr 14 2006,Sam M. '07,They may take our lives,http://mitadmissions.org/blogs/entry/they_may_take_our_lives,2981,0,0,0,0
Apr 14 2006,Matt McGann '00,Weekend Update,http://mitadmissions.org/blogs/entry/weekend_update,2981,0,0,0,0
Apr 14 2006,Bryan O. '09,Awkward Moment,http://mitadmissions.org/blogs/entry/awkward_moment,2981,0,0,0,0
Apr 14 2006,Melis A. '08,The Onion article about Robot Hazing at MIT,http://mitadmissions.org/blogs/entry/the_onion_article_about_robot,2981,1,0,0,1
Apr 13 2006,Matt McGann '00,Juniors: Sign up for SAT Subject Tests,http://mitadmissions.org/blogs/entry/juniors_sign_up_for_sat_subjec,2982,0,0,0,0
Apr 13 2006,Bryan O. '09,"Adventures in Italy, Part 2",http://mitadmissions.org/blogs/entry/adventures_in_italy_part_2,2982,0,0,0,0
Apr 12 2006,Matt McGann '00,...being a geek works out,http://mitadmissions.org/blogs/entry/being_a_geek_works_out,2983,0,0,0,0
Apr 12 2006,Sam M. '07,Profiles in Courage,http://mitadmissions.org/blogs/entry/profiles_in_courage,2983,0,0,0,0
Apr 12 2006,Mollie B. '06,Airplane boy strikes again,http://mitadmissions.org/blogs/entry/airplane_boy_strikes_again,2983,0,0,0,0
Apr 11 2006,Matt McGann '00,CPW Wrapup,http://mitadmissions.org/blogs/entry/cpw_wrapup,2984,0,0,0,0
Apr 11 2006,Melis A. '08,Summary of CPW 2006,http://mitadmissions.org/blogs/entry/summary_of_cpw_2006,2984,0,0,0,0
Apr 10 2006,Anthony R. '09,Back to work,http://mitadmissions.org/blogs/entry/back_to_work,2985,0,0,0,0
Apr 10 2006,Matt McGann '00,Cannon Hack,http://mitadmissions.org/blogs/entry/cannon_hack,2985,0,0,0,0
Apr 10 2006,Mitra L. '07,Back Bay 5K,http://mitadmissions.org/blogs/entry/back_bay_5k,2985,0,0,0,0
Apr 9 2006,Bryan O. '09,The Secret Life Of Marilee Jones,http://mitadmissions.org/blogs/entry/the_secret_life_of_marilee_jon,2986,0,0,0,0
Apr 8 2006,Mollie B. '06,The first step,http://mitadmissions.org/blogs/entry/the_first_step,2987,0,0,0,0
Apr 7 2006,Matt McGann '00,CPW 2006 Day 1,http://mitadmissions.org/blogs/entry/cpw_2006_day_1,2988,0,0,0,0
Apr 6 2006,Bryan O. '09,"Caltech, Bring IT on",http://mitadmissions.org/blogs/entry/caltech_bring_it_on,2989,0,0,0,0
Apr 6 2006,Mitra L. '07,Just Saying,http://mitadmissions.org/blogs/entry/just_saying,2989,0,0,0,0
Apr 6 2006,Jessie L. '07,MIT hacks Caltech,http://mitadmissions.org/blogs/entry/mit_hacks_caltech,2989,0,0,0,0
Apr 6 2006,Ben Jones,Best. Hack. Ever.,http://mitadmissions.org/blogs/entry/best_hack_ever,2989,0,2,0,2
Apr 6 2006,Sam M. '07,CPW 4 U,http://mitadmissions.org/blogs/entry/cpw_4_u,2989,0,0,0,0
Apr 6 2006,Melis A. '08,Campus Preview Weekend,http://mitadmissions.org/blogs/entry/campus_preview_weekend_1,2989,0,0,0,0
Apr 5 2006,Bryan O. '09,"Adventures in Italy, Part 1",http://mitadmissions.org/blogs/entry/adventures_in_italy_part_1,2990,0,0,0,0
Apr 5 2006,Matt McGann '00,Questions & Coca-Cola Check-in,http://mitadmissions.org/blogs/entry/questions_cocacola_checkin,2990,0,0,0,0
Apr 5 2006,Mollie B. '06,CPW-related whatsits,http://mitadmissions.org/blogs/entry/cpwrelated_whatsits,2990,0,0,0,0
Apr 5 2006,Sam M. '07,Fame,http://mitadmissions.org/blogs/entry/fame,2990,0,0,0,0
Apr 4 2006,Mitra L. '07,Holy Cow,http://mitadmissions.org/blogs/entry/holy_cow,2991,0,0,0,0
Apr 4 2006,Matt McGann '00,"Answers, and live updates",http://mitadmissions.org/blogs/entry/answers_and_live_updates,2991,0,0,0,0
Apr 4 2006,Sam M. '07,"Mitra, its your birthday.",http://mitadmissions.org/blogs/entry/mitra_its_your_birthday,2991,0,0,0,0
Apr 3 2006,Mitra L. '07,Since I Been Gone,http://mitadmissions.org/blogs/entry/since_i_been_gone,2992,0,0,0,0
Apr 2 2006,Mollie B. '06,This is just a tribute,http://mitadmissions.org/blogs/entry/this_is_just_a_tribute,2993,0,0,0,0
Apr 2 2006,Melis A. '08,Dont Miss the Battle of the Bands,http://mitadmissions.org/blogs/entry/dont_miss_the_battle_of_the_ba,2993,1,0,0,1
Apr 2 2006,Matt McGann '00,Your CPW Host,http://mitadmissions.org/blogs/entry/your_cpw_host,2993,0,0,0,0
Apr 2 2006,Laura N. '09,I less than 3 the Chorallaries,http://mitadmissions.org/blogs/entry/i_less_than_3_the_chorallaries,2993,0,0,0,0
Apr 2 2006,Anthony R. '09,Preparing for CPW,http://mitadmissions.org/blogs/entry/preparing_for_cpw,2993,0,0,0,0
Apr 1 2006,Sam M. '07,Since U Been Gone,http://mitadmissions.org/blogs/entry/since_u_been_gone,2994,0,0,0,0
Mar 31 2006,Matt McGann '00,Odds & Evens & Ends,http://mitadmissions.org/blogs/entry/odds_evens_ends,2995,0,0,0,0
Mar 31 2006,Jessie L. '07,Answering your questions,http://mitadmissions.org/blogs/entry/answering_your_questions,2995,0,0,0,0
Mar 30 2006,Ben Jones,Campus Preview Weekend,http://mitadmissions.org/blogs/entry/campus_preview_weekend,2996,0,0,0,0
Mar 30 2006,Mollie B. '06,Home sweet violet capital of Ohio,http://mitadmissions.org/blogs/entry/home_sweet_violet_capital_of_o,2996,0,0,0,0
Mar 30 2006,Mitra L. '07,Crazy Day,http://mitadmissions.org/blogs/entry/crazy_day,2996,0,0,0,0
Mar 29 2006,Laura N. '09,FIRST fun,http://mitadmissions.org/blogs/entry/first_fun,2997,0,0,0,0
Mar 29 2006,Bryan G. Nance,"A Post For Parents, Part 2",http://mitadmissions.org/blogs/entry/a_post_for_parents_part_2,2997,0,0,0,0
Mar 29 2006,Matt McGann '00,MIT Cancer Research,http://mitadmissions.org/blogs/entry/mit_cancer_research,2997,0,0,0,0
Mar 28 2006,Melis A. '08,Professor Ernesto Blanco: A Lesson in Creative Engineering,http://mitadmissions.org/blogs/entry/professor_ernesto_blanco_a_les,2998,23,6,3,32
Mar 28 2006,Mitra L. '07,HST Forum 2006 for real,http://mitadmissions.org/blogs/entry/hst_forum_2006_for_real,2998,0,0,0,0
Mar 27 2006,Sam M. '07,Google Maps is NOT the best.,http://mitadmissions.org/blogs/entry/google_maps_is_not_the_best,2999,0,0,0,0
Mar 27 2006,Bryan O. '09,Bryan is alive and in Rome,http://mitadmissions.org/blogs/entry/bryan_is_alive_and_in_rome,2999,0,0,0,0
Mar 27 2006,Matt McGann '00,Admitted Updates,http://mitadmissions.org/blogs/entry/admitted_updates,2999,0,0,0,0
Mar 27 2006,Matt McGann '00,Waitlist post,http://mitadmissions.org/blogs/entry/waitlist_post,2999,0,0,0,0
Mar 25 2006,Mollie B. '06,Living la vida lab rat,http://mitadmissions.org/blogs/entry/living_la_vida_lab_rat,3001,0,0,0,0
Mar 25 2006,Bryan O. '09,Rome!,http://mitadmissions.org/blogs/entry/rome,3001,0,0,0,0
Mar 25 2006,Sam M. '07,Super Adventure Club,http://mitadmissions.org/blogs/entry/super_adventure_club,3001,0,0,0,0
Mar 25 2006,Sam M. '07,"Knowing me, knowing you",http://mitadmissions.org/blogs/entry/knowing_me_knowing_you,3001,0,0,0,0
Mar 24 2006,Matt McGann '00,Admitted Students Parties,http://mitadmissions.org/blogs/entry/admitted_students_parties_1,3002,0,0,0,0
Mar 24 2006,Laura N. '09,Congratulations! You got the job.,http://mitadmissions.org/blogs/entry/congratulations_you_got_the_jo,3002,0,0,0,0
Mar 23 2006,Matt McGann '00,Admitted Students: MyMIT Updated,http://mitadmissions.org/blogs/entry/admitted_students_mymit_update,3003,0,0,0,0
Mar 23 2006,Ben Jones,The Only Answer I Have,http://mitadmissions.org/blogs/entry/the_only_answer_i_have,3003,0,0,0,0
Mar 23 2006,Bryan O. '09,Spring Break!,http://mitadmissions.org/blogs/entry/spring_break,3003,0,0,0,0
Mar 22 2006,Sam M. '07,"Its bigger than you, and you are not me.",http://mitadmissions.org/blogs/entry/its_bigger_than_you_and_you_ar,3004,1,1,0,2
Mar 21 2006,Laura N. '09,Uh-oh,http://mitadmissions.org/blogs/entry/uhoh,3005,0,0,0,0
Mar 21 2006,Bryan O. '09,You Heard It Here First,http://mitadmissions.org/blogs/entry/you_heard_it_here_first,3005,0,0,0,0
Mar 21 2006,Mitra L. '07,Literature Tea & Mural Contest,http://mitadmissions.org/blogs/entry/literature_tea_mural_contest,3005,0,0,0,0
Mar 21 2006,Melis A. '08,Christina Royce: Analyzing Re-entry Systems,http://mitadmissions.org/blogs/entry/christina_royce_analyzing_reen,3005,0,0,0,0
Mar 20 2006,Mollie B. '06,MIT women,http://mitadmissions.org/blogs/entry/mit_women,3006,0,0,0,0
Mar 19 2006,Sam M. '07,All my pasts and futures,http://mitadmissions.org/blogs/entry/all_my_pasts_and_futures,3007,0,0,0,0
Mar 19 2006,Laura N. '09,When life hands you lemons,http://mitadmissions.org/blogs/entry/when_life_hands_you_lemons,3007,0,0,0,0
Mar 19 2006,Jessie L. '07,The question thread,http://mitadmissions.org/blogs/entry/the_question_thread,3007,0,0,0,0
Mar 18 2006,Matt McGann '00,Admitted!,http://mitadmissions.org/blogs/entry/admitted_3,3008,0,0,0,0
Mar 18 2006,Matt McGann '00,Not admitted,http://mitadmissions.org/blogs/entry/not_admitted_1,3008,0,0,0,0
Mar 18 2006,Matt McGann '00,Waitlisted,http://mitadmissions.org/blogs/entry/waitlisted_1,3008,1,0,0,1
Mar 18 2006,Matt McGann '00,Reading,http://mitadmissions.org/blogs/entry/reading,3008,0,1,0,1
Mar 18 2006,Mitra L. '07,Admissions Decisions,http://mitadmissions.org/blogs/entry/admissions_decisions,3008,0,0,0,0
Mar 18 2006,Laura N. '09,The Moment of Truth,http://mitadmissions.org/blogs/entry/the_moment_of_truth,3008,0,0,0,0
Mar 18 2006,Anthony R. '09,Poaching Imagination,http://mitadmissions.org/blogs/entry/poaching_imagination,3008,0,0,0,0
Mar 18 2006,Mitra L. '07,Cross-Cultural Conference,http://mitadmissions.org/blogs/entry/crosscultural_conference,3008,0,0,0,0
Mar 17 2006,Ben Jones,Its More Than A Job,http://mitadmissions.org/blogs/entry/its_more_than_a_job,3009,777,219,212,1208
Mar 17 2006,Bryan O. '09,"Dont Worry, Be Happy",http://mitadmissions.org/blogs/entry/dont_worry_be_happy,3009,0,0,0,0
Mar 17 2006,Matt McGann '00,Decisions are in the mail,http://mitadmissions.org/blogs/entry/decisions_are_in_the_mail,3009,0,0,0,0
Mar 17 2006,Bryan G. Nance,Its All About The Process,http://mitadmissions.org/blogs/entry/its_all_about_the_process,3009,0,0,0,0
Mar 17 2006,Bryan G. Nance,"A Post For Parents, Part 1",http://mitadmissions.org/blogs/entry/a_post_for_parents_part_1,3009,0,0,0,0
Mar 17 2006,Ben Jones,Wont Be Long Now,http://mitadmissions.org/blogs/entry/wont_be_long_now,3009,0,0,0,0
Mar 17 2006,Mollie B. '06,Friday morning potpourri in lab,http://mitadmissions.org/blogs/entry/friday_morning_potpourri_in_la,3009,0,0,0,0
Mar 17 2006,Anthony R. '09,I AM SO BUSY,http://mitadmissions.org/blogs/entry/i_am_so_busy,3009,0,0,0,0
Mar 17 2006,Sam M. '07,Antici,http://mitadmissions.org/blogs/entry/antici,3009,0,0,0,0
Mar 16 2006,Matt McGann '00,Mailing Tomorrow; Yo-Yo Tonight,http://mitadmissions.org/blogs/entry/mailing_tomorrow_yoyo_tonight,3010,0,0,0,0
Mar 15 2006,Laura N. '09,Academic Marathon,http://mitadmissions.org/blogs/entry/academic_marathon,3011,0,0,0,0
Mar 15 2006,Matt McGann '00,The Ides of March,http://mitadmissions.org/blogs/entry/the_ides_of_march_1,3011,0,0,0,0
Mar 15 2006,Sam M. '07,Ides of March,http://mitadmissions.org/blogs/entry/ides_of_march,3011,0,0,0,0
Mar 14 2006,Mollie B. '06,Adam makes a guest appearance,http://mitadmissions.org/blogs/entry/adam_makes_a_guest_appearance,3012,0,0,0,0
Mar 14 2006,Mitra L. '07,Happy Pi Day,http://mitadmissions.org/blogs/entry/happy_pi_day_1,3012,0,0,0,0
Mar 14 2006,Bryan O. '09,Happy Pi Day!,http://mitadmissions.org/blogs/entry/happy_pi_day,3012,1,4,1,6
Mar 14 2006,Sam M. '07,Pervnert,http://mitadmissions.org/blogs/entry/pervnert,3012,0,1,0,1
Mar 12 2006,Bryan O. '09,Battle of The Bands takes over Bryans Blog,http://mitadmissions.org/blogs/entry/battle_of_the_bands_takes_over,3014,0,0,0,0
Mar 12 2006,Melis A. '08,Etiquette Workshop: The Keys to Painless Networking,http://mitadmissions.org/blogs/entry/etiquette_workshop_the_keys_to,3014,0,0,0,0
Mar 12 2006,Mollie B. '06,Spring cleaning and miscellany,http://mitadmissions.org/blogs/entry/spring_cleaning_and_miscellany,3014,0,0,0,0
Mar 12 2006,Anthony R. '09,My Second Fifth Week?,http://mitadmissions.org/blogs/entry/my_second_fifth_week,3014,0,0,0,0
Mar 11 2006,Ben Jones,Selection = Finished,http://mitadmissions.org/blogs/entry/selection_finished,3015,0,0,0,0
Mar 11 2006,Laura N. '09,Maybe later,http://mitadmissions.org/blogs/entry/maybe_later,3015,0,0,0,0
Mar 11 2006,Sam M. '07,The Parafilm Effect,http://mitadmissions.org/blogs/entry/the_parafilm_effect,3015,0,0,0,0
Mar 9 2006,Melis A. '08,Biochemistry at its finest!,http://mitadmissions.org/blogs/entry/biochemistry_at_its_finest,3017,0,0,0,0
Mar 9 2006,Laura N. '09,Newsflash!,http://mitadmissions.org/blogs/entry/newsflash,3017,0,0,0,0
Mar 9 2006,Ben Jones,Financial Aid Tracking Portlet Now Available,http://mitadmissions.org/blogs/entry/financial_aid_tracking_portlet,3017,0,0,0,0
Mar 9 2006,Bryan O. '09,"Another Day, Another Class",http://mitadmissions.org/blogs/entry/another_day_another_class,3017,0,0,0,0
Mar 8 2006,Ben Jones,The Role Of A Teacher,http://mitadmissions.org/blogs/entry/the_role_of_a_teacher,3018,0,0,0,0
Mar 7 2006,Mollie B. '06,Why I came to MIT,http://mitadmissions.org/blogs/entry/why_i_came_to_mit,3019,0,0,0,0
Mar 7 2006,Matt McGann '00,Admissions Updates,http://mitadmissions.org/blogs/entry/admissions_updates,3019,0,0,0,0
Mar 7 2006,Daniel Barkowitz,Pell News,http://mitadmissions.org/blogs/entry/pell_news,3019,0,0,0,0
Mar 6 2006,Sam M. '07,A person can develop a cough.,http://mitadmissions.org/blogs/entry/a_person_can_develop_a_cough,3020,0,0,0,0
Mar 6 2006,Mitra L. '07,Delicious Dilemma,http://mitadmissions.org/blogs/entry/delicious_dilemma,3020,0,0,0,0
Mar 6 2006,Ben Jones,Online Decisions = YES,http://mitadmissions.org/blogs/entry/online_decisions_yes,3020,0,0,0,0
Mar 5 2006,Matt McGann '00,Fondue: fun and done,http://mitadmissions.org/blogs/entry/fondue_fun_and_done,3021,0,2,0,2
Mar 5 2006,Melis A. '08,Melis and the AXO Chocolate Factory,http://mitadmissions.org/blogs/entry/melis_and_the_axo_chocolate_fa,3021,0,0,0,0
Mar 5 2006,Mitra L. '07,Bio?,http://mitadmissions.org/blogs/entry/bio,3021,0,0,0,0
Mar 3 2006,Laura N. '09,Conversations with graders,http://mitadmissions.org/blogs/entry/conversations_with_graders,3023,0,0,0,0
Mar 3 2006,Sam M. '07,Making it work.,http://mitadmissions.org/blogs/entry/making_it_work,3023,1,5,0,6
Mar 3 2006,Mollie B. '06,The interview life,http://mitadmissions.org/blogs/entry/the_interview_life,3023,0,0,0,0
Mar 2 2006,Mitra L. '07,True Love,http://mitadmissions.org/blogs/entry/true_love,3024,0,0,0,0
Mar 2 2006,Melis A. '08,Tomorrow is MacVicar day!,http://mitadmissions.org/blogs/entry/tomorrow_is_macvicar_day,3024,0,0,0,0
Mar 2 2006,Ben Jones,MIT Meets The OC,http://mitadmissions.org/blogs/entry/mit_meets_the_oc,3024,0,0,0,0
Mar 2 2006,Jessie L. '07,MIT wins the gold,http://mitadmissions.org/blogs/entry/mit_wins_the_gold,3024,0,0,0,0
Mar 1 2006,Mollie B. '06,Hello from Palo Alto,http://mitadmissions.org/blogs/entry/hello_from_palo_alto,3025,0,0,0,0
Mar 1 2006,Ben Jones,Financial Aid Tracking + Evie Pix,http://mitadmissions.org/blogs/entry/financial_aid_tracking_evie_pi,3025,0,0,0,0
Mar 1 2006,Matt McGann '00,More quick answers,http://mitadmissions.org/blogs/entry/more_quick_answers,3025,0,0,0,0
Feb 28 2006,Bryan O. '09,A Sweet Deal,http://mitadmissions.org/blogs/entry/a_sweet_deal,3026,0,0,0,0
Feb 28 2006,Mitra L. '07,Indra Nooyi presentation,http://mitadmissions.org/blogs/entry/indra_nooyi_presentation,3026,0,0,0,0
Feb 28 2006,Sam M. '07,"Citius, Altius, Mens et Manus",http://mitadmissions.org/blogs/entry/citius_altius_mens_et_manus,3026,0,0,0,0
Feb 27 2006,Ben Jones,Fun With Photoshop,http://mitadmissions.org/blogs/entry/fun_with_photoshop,3027,0,0,0,0
Feb 27 2006,Laura N. '09,My Relaxing Weekend,http://mitadmissions.org/blogs/entry/my_relaxing_weekend,3027,0,0,0,0
Feb 26 2006,Matt McGann '00,Professorial Help,http://mitadmissions.org/blogs/entry/professorial_help,3028,0,0,0,0
Feb 26 2006,Bryan O. '09,Super Top Secret Spy Action,http://mitadmissions.org/blogs/entry/super_top_secret_spy_action,3028,0,0,0,0
Feb 25 2006,Sam M. '07,VSEPR,http://mitadmissions.org/blogs/entry/vsepr,3029,0,0,0,0
Feb 25 2006,Melis A. '08,Michael Xiang: Double UROP Extraordinaire!,http://mitadmissions.org/blogs/entry/michael_xiang_double_urop_extr,3029,0,0,0,0
Feb 24 2006,Mollie B. '06,Why I do what I do,http://mitadmissions.org/blogs/entry/why_i_do_what_i_do,3030,0,0,0,0
Feb 24 2006,Mitra L. '07,"Holmstrom, et al.",http://mitadmissions.org/blogs/entry/holmstrom_et_al,3030,0,0,0,0
Feb 23 2006,Matt McGann '00,Small Get-together Friday,http://mitadmissions.org/blogs/entry/small_gettogether_friday,3031,0,0,0,0
Feb 22 2006,Matt McGann '00,A few quick answers,http://mitadmissions.org/blogs/entry/a_few_quick_answers,3032,0,0,0,0
Feb 22 2006,Ben Jones,Mid-year Grade Reports And Other Common Questions,http://mitadmissions.org/blogs/entry/midyear_grade_reports_and_othe,3032,0,0,0,0
Feb 22 2006,Bryan O. '09,My Engineering Hero,http://mitadmissions.org/blogs/entry/my_engineering_hero,3032,0,0,0,0
Feb 22 2006,Mollie B. '06,These are a few of my favorite things,http://mitadmissions.org/blogs/entry/these_are_a_few_of_my_favorite,3032,0,0,0,0
Feb 21 2006,Ben Jones,Pi Day = Mail Day? Too Early To Know,http://mitadmissions.org/blogs/entry/pi_day_mail_day_too_early_to_k,3033,0,0,0,0
Feb 21 2006,Sam M. '07,Tuesday is the new black.,http://mitadmissions.org/blogs/entry/tuesday_is_the_new_black,3033,0,0,0,0
Feb 21 2006,Laura N. '09,Another hack,http://mitadmissions.org/blogs/entry/another_hack,3033,0,0,0,0
Feb 21 2006,Jessie L. '07,Term time again,http://mitadmissions.org/blogs/entry/term_time_again,3033,0,0,0,0
Feb 20 2006,Matt McGann '00,Selection continues,http://mitadmissions.org/blogs/entry/selection_continues,3034,0,0,0,0
Feb 20 2006,Melis A. '08,Trip to Princeton U,http://mitadmissions.org/blogs/entry/trip_to_princeton_u,3034,0,0,0,0
Feb 20 2006,Ben Jones,The Decisions Are Not In The Mail,http://mitadmissions.org/blogs/entry/the_decisions_are_not_in_the_m,3034,0,0,0,0
Feb 19 2006,Melis A. '08,The Flying Luxury Hotel of Tomorrow,http://mitadmissions.org/blogs/entry/the_flying_luxury_hotel_of_tom,3035,0,0,0,0
Feb 19 2006,Ben Jones,Howdy From The Middle Of RA Selection,http://mitadmissions.org/blogs/entry/howdy_from_the_middle_of_ra_se,3035,1,0,0,1
Feb 19 2006,Mitra L. '07,General Advice,http://mitadmissions.org/blogs/entry/general_advice,3035,0,0,0,0
Feb 18 2006,Sam M. '07,The Greek Way,http://mitadmissions.org/blogs/entry/the_greek_way,3036,0,0,0,0
Feb 17 2006,Bryan O. '09,The Double Edged Sword,http://mitadmissions.org/blogs/entry/the_double_edged_sword,3037,0,0,0,0
Feb 17 2006,Mollie B. '06,Numbers are names too,http://mitadmissions.org/blogs/entry/numbers_are_names_too,3037,2,0,0,2
Feb 17 2006,Matt McGann '00,Going for the Au,http://mitadmissions.org/blogs/entry/going_for_the_au,3037,0,0,0,0
Feb 16 2006,Matt McGann '00,Spy vs. Spy,http://mitadmissions.org/blogs/entry/spy_vs_spy,3038,0,0,0,0
Feb 16 2006,Mitra L. '07,Flowers in your hair,http://mitadmissions.org/blogs/entry/flowers_in_your_hair,3038,0,0,0,0
Feb 16 2006,Laura N. '09,And for my next trick,http://mitadmissions.org/blogs/entry/and_for_my_next_trick,3038,0,0,0,0
Feb 16 2006,Matt McGann '00,Post-Valentine Blog Roundup,http://mitadmissions.org/blogs/entry/postvalentine_blog_roundup,3038,0,0,0,0
Feb 15 2006,Mollie B. '06,Class-tastic,http://mitadmissions.org/blogs/entry/classtastic,3039,0,0,0,0
Feb 15 2006,Sam M. '07,"Our students, their stories.",http://mitadmissions.org/blogs/entry/our_students_their_stories,3039,0,0,0,0
Feb 15 2006,Anthony R. '09,My Second First Week,http://mitadmissions.org/blogs/entry/my_second_first_week,3039,0,0,0,0
Feb 14 2006,Bryan G. Nance,Introducing Two New MIT Students,http://mitadmissions.org/blogs/entry/introducing_two_new_mit_studen,3040,0,0,0,0
Feb 14 2006,Ben Jones,Bens Ninth Semi-Annual Q&A,http://mitadmissions.org/blogs/entry/bens_ninth_semiannual_qa,3040,0,0,0,0
Feb 14 2006,Bryan O. '09,Love Potion No. 9,http://mitadmissions.org/blogs/entry/love_potion_no_9,3040,0,0,0,0
Feb 14 2006,Sam M. '07,Dies Irae,http://mitadmissions.org/blogs/entry/dies_irae,3040,0,0,0,0
Feb 13 2006,Matt McGann '00,A bevy of beautiful Brass Rat bezels,http://mitadmissions.org/blogs/entry/a_bevy_of_beautiful_brass_rat,3041,0,2,0,2
Feb 13 2006,Bryan O. '09,Q&A Round Two,http://mitadmissions.org/blogs/entry/qa_round_two,3041,0,0,0,0
Feb 12 2006,Melis A. '08,Formula SAE: A Turbocharged Experience,http://mitadmissions.org/blogs/entry/formula_sae_a_turbocharged_exp,3042,0,0,0,0
Feb 12 2006,Mollie B. '06,Weathering the weather,http://mitadmissions.org/blogs/entry/weathering_the_weather,3042,0,0,0,0
Feb 12 2006,Mitra L. '07,Chocolate Tasting,http://mitadmissions.org/blogs/entry/chocolate_tasting,3042,0,0,0,0
Feb 11 2006,Ben Jones,For My Fellow Coffee Lovers,http://mitadmissions.org/blogs/entry/for_my_fellow_coffee_lovers,3043,0,0,0,0
Feb 11 2006,Melis A. '08,Presentingthe 2008 Brass Rat!!!,http://mitadmissions.org/blogs/entry/presentingthe_2008_brass_rat,3043,1,0,0,1
Feb 10 2006,Sam M. '07,"Ho-dee-hi, hi-dee-ho, ho ho.",http://mitadmissions.org/blogs/entry/hodeehi_hideeho_ho_ho,3044,0,0,0,0
Feb 10 2006,Mollie B. '06,Answering my own questions,http://mitadmissions.org/blogs/entry/answering_my_own_questions,3044,0,0,0,0
Feb 9 2006,Matt McGann '00,The Year of the Origami Dog,http://mitadmissions.org/blogs/entry/the_year_of_the_origami_dog,3045,0,1,0,1
Feb 8 2006,Sam M. '07,I will begin again.,http://mitadmissions.org/blogs/entry/i_will_begin_again,3046,0,0,0,0
Feb 8 2006,Ben Jones,Regarding Online Decisions,http://mitadmissions.org/blogs/entry/regarding_online_decisions,3046,0,0,0,0
Feb 8 2006,Mitra L. '07,Engagement Party,http://mitadmissions.org/blogs/entry/engagement_party,3046,0,0,0,0
Feb 7 2006,Matt McGann '00,Letting the days go by,http://mitadmissions.org/blogs/entry/letting_the_days_go_by,3047,0,0,0,0
Feb 7 2006,Daniel Barkowitz,"Daniel Barkowitz is alive well, and moving to Dedham",http://mitadmissions.org/blogs/entry/daniel_barkowitz_is_alive_well,3047,0,0,0,0
Feb 7 2006,Bryan O. '09,Spring Term 2006!,http://mitadmissions.org/blogs/entry/spring_term_2006,3047,0,0,0,0
Feb 7 2006,Mollie B. '06,The first of the lasts,http://mitadmissions.org/blogs/entry/the_first_of_the_lasts,3047,0,0,0,0
Feb 7 2006,Anthony R. '09,Baby Steps,http://mitadmissions.org/blogs/entry/baby_steps,3047,0,0,0,0
Feb 6 2006,Ben Jones,The New MIT Viewbook!,http://mitadmissions.org/blogs/entry/the_new_mit_viewbook,3048,0,0,0,0
Feb 6 2006,Sam M. '07,The kindest cut,http://mitadmissions.org/blogs/entry/the_kindest_cut,3048,0,0,0,0
Feb 5 2006,Melis A. '08,UPOP Program and a look at Jay Dweck (77),http://mitadmissions.org/blogs/entry/upop_program_and_a_look_at_jay,3049,2,0,0,2
Feb 5 2006,Laura N. '09,Freshman Musical Dorms,http://mitadmissions.org/blogs/entry/freshman_musical_dorms,3049,0,8,0,8
Feb 5 2006,Mitra L. '07,14.11: Putting Social Science to the TestField Experiments in Economics,http://mitadmissions.org/blogs/entry/1411putting_social_science_to,3049,0,0,0,0
Feb 4 2006,Mollie B. '06,"Culture, not the bacterial kind",http://mitadmissions.org/blogs/entry/culture_not_the_bacterial_kind,3050,0,0,0,0
Feb 3 2006,Matt McGann '00,Same as it ever was,http://mitadmissions.org/blogs/entry/same_as_it_ever_was,3051,0,0,0,0
Feb 3 2006,Bryan O. '09,Kiss the Frog,http://mitadmissions.org/blogs/entry/kiss_the_frog,3051,0,0,0,0
Feb 3 2006,Jessie L. '07,Mind and hand,http://mitadmissions.org/blogs/entry/mind_and_hand,3051,5,3,0,8
Feb 2 2006,Melis A. '08,Not your stereotypical sorority girl,http://mitadmissions.org/blogs/entry/not_your_stereotypical_sororit,3052,0,0,0,0
Feb 2 2006,Sam M. '07,Summerteeth,http://mitadmissions.org/blogs/entry/summerteeth,3052,0,0,0,0
Feb 2 2006,Ben Jones,Superbowl,http://mitadmissions.org/blogs/entry/superbowl,3052,0,0,0,0
Feb 2 2006,Bryan O. '09,"I, Robot",http://mitadmissions.org/blogs/entry/i_robot,3052,0,0,0,0
Jan 31 2006,Bryan O. '09,Tuesdays with Linda,http://mitadmissions.org/blogs/entry/tuesdays_with_linda,3054,0,0,0,0
Jan 31 2006,Matt McGann '00,"Its snowing, and Its Raining",http://mitadmissions.org/blogs/entry/its_snowing_and_its_raining,3054,0,0,0,0
Jan 31 2006,Mollie B. '06,Science is apparently not for the easily-frustrated,http://mitadmissions.org/blogs/entry/science_is_apparently_not_for,3054,2,2,3,7
Jan 31 2006,Sam M. '07,Underneath your curves,http://mitadmissions.org/blogs/entry/underneath_your_curves,3054,0,0,0,0
Jan 29 2006,Sam M. '07,"Love, organically",http://mitadmissions.org/blogs/entry/love_organically,3056,0,0,0,0
Jan 29 2006,Matt McGann '00,Year of the Dog,http://mitadmissions.org/blogs/entry/year_of_the_dog,3056,0,0,0,0
Jan 28 2006,Laura N. '09,And now for the feature presentation,http://mitadmissions.org/blogs/entry/and_now_for_the_feature_presen,3057,0,0,0,0
Jan 27 2006,Bryan O. '09,Get The Scoop,http://mitadmissions.org/blogs/entry/get_the_scoop,3058,0,0,0,0
Jan 27 2006,Mollie B. '06,Out of the lab and into the internet,http://mitadmissions.org/blogs/entry/out_of_the_lab_and_into_the_in,3058,0,0,0,0
Jan 27 2006,Matt McGann '00,Other summer programs,http://mitadmissions.org/blogs/entry/other_summer_programs,3058,0,1,0,1
Jan 27 2006,Anthony R. '09,Randomness,http://mitadmissions.org/blogs/entry/randomness,3058,0,0,0,0
Jan 27 2006,Melis A. '08,Visit to the Museum of Fine Arts,http://mitadmissions.org/blogs/entry/visit_to_the_museum_of_fine_ar,3058,0,0,0,0
Jan 27 2006,Sam M. '07,Time passes,http://mitadmissions.org/blogs/entry/time_passes,3058,0,0,0,0
Jan 27 2006,Laura N. '09,EA Telethon!,http://mitadmissions.org/blogs/entry/ea_telethon,3058,0,0,0,0
Jan 25 2006,Matt McGann '00,Television,http://mitadmissions.org/blogs/entry/television,3060,0,0,0,0
Jan 25 2006,Matt McGann '00,"MITES, RSI and WTP applications due next week",http://mitadmissions.org/blogs/entry/mites_rsi_and_wtp_applications,3060,0,0,0,0
Jan 25 2006,Mollie B. '06,Im supergirl and Im here to save the world,http://mitadmissions.org/blogs/entry/im_supergirl_and_im_here_to_sa,3060,0,0,0,0
Jan 25 2006,Sam M. '07,SMRT,http://mitadmissions.org/blogs/entry/smrt,3060,0,0,0,0
Jan 24 2006,Ben Jones,Bens Eighth Semi-Annual Q&A,http://mitadmissions.org/blogs/entry/bens_eighth_semiannual_qa,3061,0,0,0,0
Jan 24 2006,Matt McGann '00,January Questions Omnibus 1,http://mitadmissions.org/blogs/entry/january_questions_omnibus_1,3061,0,0,0,0
Jan 24 2006,Sam M. '07,Seen and Not Seen,http://mitadmissions.org/blogs/entry/seen_and_not_seen,3061,0,0,0,0
Jan 23 2006,Matt McGann '00,Beautiful snowfall,http://mitadmissions.org/blogs/entry/beautiful_snowfall,3062,0,0,0,0
Jan 23 2006,Bryan O. '09,Saturday Roadtrip,http://mitadmissions.org/blogs/entry/saturday_roadtrip,3062,0,0,0,0
Jan 22 2006,Bryan O. '09,More on DesigNerds,http://mitadmissions.org/blogs/entry/more_on_designerds,3063,0,0,0,0
Jan 22 2006,Jessie L. '07,Where have I been for so long?,http://mitadmissions.org/blogs/entry/where_have_i_been_for_so_long,3063,0,0,0,0
Jan 22 2006,Laura N. '09,Im still here.,http://mitadmissions.org/blogs/entry/im_still_here,3063,0,0,0,0
Jan 21 2006,Mollie B. '06,Burning questions,http://mitadmissions.org/blogs/entry/burning_questions,3064,0,0,0,0
Jan 20 2006,Mollie B. '06,Grad school admissions,http://mitadmissions.org/blogs/entry/grad_school_admissions,3065,6,6,8,20
Jan 20 2006,Anthony R. '09,"Wow, work!",http://mitadmissions.org/blogs/entry/wow_work,3065,0,0,0,0
Jan 20 2006,Melis A. '08,2.670 Summary,http://mitadmissions.org/blogs/entry/2670_summary,3065,0,0,0,0
Jan 20 2006,Mitra L. '07,Taste of the Middle Ages,http://mitadmissions.org/blogs/entry/taste_of_the_middle_ages,3065,0,0,0,0
Jan 20 2006,Melis A. '08,2.670 Stirling Engine Spinoff,http://mitadmissions.org/blogs/entry/2670_stirling_engine_spinoff,3065,0,0,0,0
Jan 19 2006,Bryan O. '09,Is this real?,http://mitadmissions.org/blogs/entry/is_this_real,3066,0,0,0,0
Jan 19 2006,Sam M. '07,So I said to Einstein,http://mitadmissions.org/blogs/entry/so_i_said_to_einstein,3066,0,0,0,0
Jan 18 2006,Bryan O. '09,Technology Happens,http://mitadmissions.org/blogs/entry/technology_happens,3067,0,0,0,0
Jan 18 2006,Matt McGann '00,"11,231 Applications",http://mitadmissions.org/blogs/entry/11231_applications,3067,2,0,0,2
Jan 18 2006,Ben Jones,Regarding The Tech Article,http://mitadmissions.org/blogs/entry/regarding_the_tech_article,3067,0,0,0,0
Jan 17 2006,Matt McGann '00,Were Up To Date!,http://mitadmissions.org/blogs/entry/were_up_to_date,3068,0,0,0,0
Jan 17 2006,Mollie B. '06,Bored at work,http://mitadmissions.org/blogs/entry/bored_at_work,3068,0,0,0,0
Jan 17 2006,Mitra L. '07,Lucky Saturday the 14th,http://mitadmissions.org/blogs/entry/lucky_saturday_the_14th,3068,0,0,0,0
Jan 16 2006,Sam M. '07,It rocks to be me.,http://mitadmissions.org/blogs/entry/it_rocks_to_be_me,3069,0,0,0,0
Jan 16 2006,Melis A. '08,2.670- Mechanical Engineering Tools- Week 1,http://mitadmissions.org/blogs/entry/2670_mechanical_engineering_to,3069,2,0,0,2
Jan 15 2006,Bryan O. '09,Mystery Hunt Highlights,http://mitadmissions.org/blogs/entry/mystery_hunt_highlights,3070,0,0,0,0
Jan 15 2006,Matt McGann '00,The Coin Is Found!,http://mitadmissions.org/blogs/entry/the_coin_is_found,3070,0,0,0,0
Jan 13 2006,Matt McGann '00,Evil Institute of Technology,http://mitadmissions.org/blogs/entry/evil_institute_of_technology,3072,0,0,0,0
Jan 13 2006,Laura N. '09,Semi-Real Time Mystery Hunt Update,http://mitadmissions.org/blogs/entry/semireal_time_mystery_hunt_upd,3072,0,0,0,0
Jan 13 2006,Bryan O. '09,Live from MYSTERY HUNT,http://mitadmissions.org/blogs/entry/live_from_mystery_hunt,3072,0,0,0,0
Jan 13 2006,Mitra L. '07,On Broadway,http://mitadmissions.org/blogs/entry/on_broadway,3072,0,0,0,0
Jan 13 2006,Mollie B. '06,MIT Athletics,http://mitadmissions.org/blogs/entry/mit_athletics,3072,0,1,0,1
Jan 13 2006,Sam M. '07,This is a song about being happy.,http://mitadmissions.org/blogs/entry/this_is_a_song_about_being_hap,3072,0,0,0,0
Jan 12 2006,Laura N. '09,Finally!,http://mitadmissions.org/blogs/entry/finally,3073,0,0,0,0
Jan 12 2006,Matt McGann '00,Mystery Hunt begins tomorrow,http://mitadmissions.org/blogs/entry/mystery_hunt_begins_tomorrow,3073,0,0,0,0
Jan 11 2006,Bryan G. Nance,The Birth Of Baby Nance,http://mitadmissions.org/blogs/entry/the_birth_of_baby_nance,3074,0,0,0,0
Jan 11 2006,Matt McGann '00,Just a Little Patience,http://mitadmissions.org/blogs/entry/just_a_little_patience,3074,0,0,0,0
Jan 11 2006,Mollie B. '06,The most wonderful time of the year,http://mitadmissions.org/blogs/entry/the_most_wonderful_time_of_the,3074,0,0,0,0
Jan 10 2006,Bryan O. '09,Musings on Graduate School,http://mitadmissions.org/blogs/entry/musings_on_graduate_school,3075,0,1,0,1
Jan 10 2006,Laura N. '09,Playing Doctor,http://mitadmissions.org/blogs/entry/playing_doctor,3075,0,0,0,0
Jan 10 2006,Mitra L. '07,First Days in NYC,http://mitadmissions.org/blogs/entry/first_days_in_nyc,3075,0,0,0,0
Jan 10 2006,Melis A. '08,Keeping it Green,http://mitadmissions.org/blogs/entry/keeping_it_green,3075,0,0,0,0
Jan 9 2006,Ben Jones,Holiday Stories,http://mitadmissions.org/blogs/entry/holiday_stories,3076,0,0,0,0
Jan 9 2006,Ben Jones,Bens Seventh Semi-Annual Q&A,http://mitadmissions.org/blogs/entry/bens_seventh_semiannual_qa,3076,0,0,0,0
Jan 9 2006,Anthony R. '09,A Visitor In My Own Hometown,http://mitadmissions.org/blogs/entry/a_visitor_in_my_own_hometown,3076,0,0,0,0
Jan 9 2006,Bryan G. Nance,How A Blog Became A Community,http://mitadmissions.org/blogs/entry/how_a_blog_became_a_community,3076,0,0,0,0
Jan 9 2006,Mollie B. '06,The land of the free and the home of the internet,http://mitadmissions.org/blogs/entry/the_land_of_the_free_and_the_h,3076,0,0,0,0
Jan 8 2006,Bryan O. '09,Just 5 Days Left!,http://mitadmissions.org/blogs/entry/just_5_days_left,3077,0,0,0,0
Jan 8 2006,Matt McGann '00,"IAP, and trivia answers",http://mitadmissions.org/blogs/entry/iap_and_trivia_answers,3077,0,0,0,0
Jan 7 2006,Jessie L. '07,Some comments on topics of interest,http://mitadmissions.org/blogs/entry/some_comments_on_topics_of_int,3078,0,0,0,0
Jan 6 2006,Sam M. '07,I won the game!,http://mitadmissions.org/blogs/entry/i_won_the_game,3079,0,0,0,0
Jan 6 2006,Matt McGann '00,State of the Mail,http://mitadmissions.org/blogs/entry/state_of_the_mail,3079,0,0,0,0
Jan 5 2006,Bryan O. '09,I Am Prepared!,http://mitadmissions.org/blogs/entry/i_am_prepared,3080,0,0,0,0
Jan 3 2006,Mollie B. '06,Not an actual entry,http://mitadmissions.org/blogs/entry/not_an_actual_entry,3082,0,0,0,0
Jan 3 2006,Mitra L. '07,IAP 2006,http://mitadmissions.org/blogs/entry/iap_2006,3082,0,0,0,0
Jan 3 2006,Sam M. '07,The Ballad of Sir Frankie Crisp (Let It Roll),http://mitadmissions.org/blogs/entry/the_ballad_of_sir_frankie_cris,3082,0,0,0,0
Jan 3 2006,Jessie L. '07,What have I been doing this break?,http://mitadmissions.org/blogs/entry/what_have_i_been_doing_this_br,3082,0,0,0,0
Jan 2 2006,Matt McGann '00,New Year Notes,http://mitadmissions.org/blogs/entry/new_year_notes,3083,0,0,0,0
Jan 2 2006,Sam M. '07,Jeux sans frontieres,http://mitadmissions.org/blogs/entry/jeux_sans_frontieres,3083,0,0,0,0
Jan 2 2006,Ben Jones,2006 Already?!?,http://mitadmissions.org/blogs/entry/2006_already,3083,0,0,0,0
Jan 1 2006,Bryan O. '09,A New Year and a New Do,http://mitadmissions.org/blogs/entry/a_new_year_and_a_new_do,3084,0,0,0,0
Dec 31 2005,Bryan O. '09,"Peace Out, 2005",http://mitadmissions.org/blogs/entry/peace_out_2005,3085,0,0,0,0
Dec 31 2005,Laura N. '09,Just a little advice,http://mitadmissions.org/blogs/entry/just_a_little_advice,3085,0,0,0,0
Dec 30 2005,Matt McGann '00,December Questions Omnibus 2,http://mitadmissions.org/blogs/entry/december_questions_omnibus_2,3086,0,0,0,0
Dec 28 2005,Sam M. '07,"Tuesdays with Menorah, eek!",http://mitadmissions.org/blogs/entry/tuesdays_with_menorah_eek,3088,0,0,0,0
Dec 28 2005,Mollie B. '06,More from Ahia,http://mitadmissions.org/blogs/entry/more_from_ahia,3088,0,0,0,0
Dec 28 2005,Bryan O. '09,My Winter Break Reading List,http://mitadmissions.org/blogs/entry/my_winter_break_reading_list,3088,0,0,0,0
Dec 28 2005,Matt McGann '00,Upcoming non-MIT deadlines,http://mitadmissions.org/blogs/entry/upcoming_nonmit_deadlines,3088,0,0,0,0
Dec 27 2005,Matt McGann '00,Upcoming MIT Deadline,http://mitadmissions.org/blogs/entry/upcoming_mit_deadline,3089,0,0,0,0
Dec 27 2005,Sam M. '07,Song of Myself,http://mitadmissions.org/blogs/entry/song_of_myself,3089,0,0,0,0
Dec 26 2005,Sam M. '07,I know my calculus and U2.,http://mitadmissions.org/blogs/entry/i_know_my_calculus_and_u2,3090,0,0,0,0
Dec 26 2005,Anthony R. '09,Happy Holidays and Good Luck,http://mitadmissions.org/blogs/entry/happy_holidays_and_good_luck,3090,0,0,0,0
Dec 25 2005,Matt McGann '00,A Very McGann Christmas,http://mitadmissions.org/blogs/entry/a_very_mcgann_christmas,3091,0,0,0,0
Dec 24 2005,Jessie L. '07,Giving Laura an assist,http://mitadmissions.org/blogs/entry/giving_laura_an_assist,3092,0,0,0,0
Dec 24 2005,Mollie B. '06,"Home is the place where, when you have to go there, they have to take you in",http://mitadmissions.org/blogs/entry/home_is_the_place_where_when_y,3092,0,0,0,0
Dec 24 2005,Matt McGann '00,December Questions Omnibus 1,http://mitadmissions.org/blogs/entry/december_questions_omnibus_1,3092,0,0,0,0
Dec 23 2005,Jessie L. '07,"Happy Holidays, and some advice",http://mitadmissions.org/blogs/entry/happy_holidays_and_some_advice,3093,0,0,0,0
Dec 22 2005,Ben Jones,Happy New Year Everyone!,http://mitadmissions.org/blogs/entry/happy_new_year_everyone,3094,0,0,0,0
Dec 22 2005,Ben Jones,Bens Sixth Semi-Annual Q&A,http://mitadmissions.org/blogs/entry/bens_sixth_semiannual_qa,3094,0,0,0,0
Dec 22 2005,Sam M. '07,Art?,http://mitadmissions.org/blogs/entry/art,3094,0,0,0,0
Dec 21 2005,Matt McGann '00,More Notes,http://mitadmissions.org/blogs/entry/more_notes,3095,0,0,0,0
Dec 21 2005,Bryan O. '09,Counting On One Hand,http://mitadmissions.org/blogs/entry/counting_on_one_hand,3095,0,0,0,0
Dec 20 2005,Mitra L. '07,MIT in the news,http://mitadmissions.org/blogs/entry/mit_in_the_news,3096,0,0,0,0
Dec 20 2005,Mollie B. '06,Trouble staying focused,http://mitadmissions.org/blogs/entry/trouble_staying_focused,3096,0,0,0,0
Dec 20 2005,Sam M. '07,"Psycho kitten, quest-ce que cest?",http://mitadmissions.org/blogs/entry/psycho_kitten_questce_que_cest,3096,0,0,0,0
Dec 20 2005,Laura N. '09,Tricky Questions,http://mitadmissions.org/blogs/entry/tricky_questions,3096,0,0,0,0
Dec 20 2005,Melis A. '08,Cool UROP position,http://mitadmissions.org/blogs/entry/cool_urop_position,3096,0,0,0,0
Dec 19 2005,Ben Jones,Happy Holidays!,http://mitadmissions.org/blogs/entry/happy_holidays,3097,0,0,0,0
Dec 19 2005,Ben Jones,Bens Fifth Semi-Annual Q&A,http://mitadmissions.org/blogs/entry/bens_fifth_semiannual_qa,3097,0,0,0,0
Dec 19 2005,Bryan O. '09,Final Examination Nation,http://mitadmissions.org/blogs/entry/final_examination_nation,3097,1,1,0,2
Dec 19 2005,Jessie L. '07,"Ack, finals!",http://mitadmissions.org/blogs/entry/ack_finals,3097,0,0,0,0
Dec 17 2005,Mitra L. '07,Last Night,http://mitadmissions.org/blogs/entry/last_night,3099,0,0,0,0
Dec 17 2005,Matt McGann '00,For Deferred Students,http://mitadmissions.org/blogs/entry/for_deferred_students,3099,0,0,0,0
Dec 17 2005,Matt McGann '00,For EA Admitted Students,http://mitadmissions.org/blogs/entry/for_ea_admitted_students,3099,0,0,0,0
Dec 17 2005,Mollie B. '06,On being a lab rat,http://mitadmissions.org/blogs/entry/on_being_a_lab_rat,3099,0,0,0,0
Dec 16 2005,Bryan O. '09,Attack of the Giant Squid,http://mitadmissions.org/blogs/entry/attack_of_the_giant_squid,3100,0,0,0,0
Dec 16 2005,Matt McGann '00,Some Notes,http://mitadmissions.org/blogs/entry/some_notes,3100,0,0,0,0
Dec 16 2005,Sam M. '07,Indiscipline,http://mitadmissions.org/blogs/entry/indiscipline,3100,0,0,0,0
Dec 16 2005,Anthony R. '09,Loose Ends,http://mitadmissions.org/blogs/entry/loose_ends,3100,0,0,0,0
Dec 16 2005,Melis A. '08,An MIT Apprentice!!!!!!,http://mitadmissions.org/blogs/entry/an_mit_apprentice,3100,0,0,0,0
Dec 15 2005,Matt McGann '00,Mario Institute of Technology hack,http://mitadmissions.org/blogs/entry/mario_institute_of_technology,3101,0,0,0,0
Dec 15 2005,Matt McGann '00,Another post from Marilee,http://mitadmissions.org/blogs/entry/another_post_from_marilee,3101,0,0,0,0
Dec 14 2005,Ben Jones,Followup To Mailing Disaster,http://mitadmissions.org/blogs/entry/followup_to_mailing_disaster,3102,0,0,0,0
Dec 14 2005,Laura N. '09,Yay! A hack!,http://mitadmissions.org/blogs/entry/yay_a_hack,3102,0,0,0,0
Dec 14 2005,Laura N. '09,Responses to comments!,http://mitadmissions.org/blogs/entry/responses_to_comments,3102,0,0,0,0
Dec 14 2005,Mitra L. '07,Bernanke to speak at Commencement!,http://mitadmissions.org/blogs/entry/bernanke_to_speak_at_commencem,3102,0,0,0,0
Dec 14 2005,Mollie B. '06,Class size,http://mitadmissions.org/blogs/entry/class_size,3102,0,0,0,0
Dec 14 2005,Ben Jones,Please Read This,http://mitadmissions.org/blogs/entry/please_read_this,3102,0,0,0,0
Dec 14 2005,Bryan O. '09,"Art in the Infinite, Vol. 2",http://mitadmissions.org/blogs/entry/art_in_the_infinite_vol_2,3102,0,0,0,0
Dec 14 2005,Ben Jones,Whats Up With The Mail?!?,http://mitadmissions.org/blogs/entry/whats_up_with_the_mail,3102,0,0,0,0
Dec 14 2005,Ben Jones,More Public Art Projects,http://mitadmissions.org/blogs/entry/more_public_art_projects,3102,0,0,0,0
Dec 14 2005,Sam M. '07,Reality is merely an illusion,http://mitadmissions.org/blogs/entry/reality_is_merely_an_illusion,3102,0,0,0,0
Dec 13 2005,Ben Jones,Decisions Beginning To Arrive,http://mitadmissions.org/blogs/entry/decisions_beginning_to_arrive,3103,0,0,0,0
Dec 13 2005,Bryan G. Nance,Welcome MIT Class of 2010!,http://mitadmissions.org/blogs/entry/welcome_mit_class_of_2010,3103,0,0,0,0
Dec 13 2005,Bryan G. Nance,Deferred?,http://mitadmissions.org/blogs/entry/deferred_2,3103,0,0,0,0
Dec 13 2005,Matt McGann '00,Admitted,http://mitadmissions.org/blogs/entry/admitted_2,3103,0,0,0,0
Dec 13 2005,Matt McGann '00,Deferred,http://mitadmissions.org/blogs/entry/deferred_1,3103,0,0,0,0
Dec 13 2005,Mollie B. '06,Sometimes a whale is just a whale,http://mitadmissions.org/blogs/entry/sometimes_a_whale_is_just_a_wh,3103,0,0,0,0
Dec 12 2005,Matt McGann '00,Required Reading,http://mitadmissions.org/blogs/entry/required_reading,3104,0,0,0,0
Dec 12 2005,Melis A. '08,Looking ahead to IAP,http://mitadmissions.org/blogs/entry/looking_ahead_to_iap,3104,0,0,0,0
Dec 11 2005,Ben Jones,Happy Sunday Everyone,http://mitadmissions.org/blogs/entry/happy_sunday_everyone,3105,0,0,0,0
Dec 11 2005,Laura N. '09,Antics!,http://mitadmissions.org/blogs/entry/antics,3105,0,0,0,0
Dec 11 2005,Sam M. '07,MIT is easy if you study rastrology.,http://mitadmissions.org/blogs/entry/mit_is_easy_if_you_study_rastr,3105,0,0,0,0
Dec 11 2005,Bryan O. '09,"Fold, Throw, Recycle",http://mitadmissions.org/blogs/entry/fold_throw_recycle,3105,0,0,0,0
Dec 10 2005,Mitra L. '07,TBP Dinner,http://mitadmissions.org/blogs/entry/tbp_dinner,3106,0,0,0,0
Dec 10 2005,Sam M. '07,Vast Oral Tradition,http://mitadmissions.org/blogs/entry/vast_oral_tradition,3106,0,0,0,0
Dec 10 2005,Bryan G. Nance,The Check Is In The Mail,http://mitadmissions.org/blogs/entry/the_check_is_in_the_mail,3106,0,0,0,0
Dec 10 2005,Matt McGann '00,Waiting,http://mitadmissions.org/blogs/entry/waiting,3106,0,0,0,0
Dec 9 2005,Jessie L. '07,The things that can change your life,http://mitadmissions.org/blogs/entry/the_things_that_can_change_you,3107,0,0,0,0
Dec 9 2005,Mollie B. '06,Photojournalism and answers to some questions,http://mitadmissions.org/blogs/entry/photojournalism_and_answers_to,3107,0,0,0,0
Dec 9 2005,Matt McGann '00,The decisions are in the mail,http://mitadmissions.org/blogs/entry/the_decisions_are_in_the_mail,3107,0,0,0,0
Dec 9 2005,Bryan G. Nance,Glimpses Of My Messy World,http://mitadmissions.org/blogs/entry/glimpses_of_my_messy_world,3107,0,0,0,0
Dec 9 2005,Ben Jones,Countdown To Mail Drop,http://mitadmissions.org/blogs/entry/countdown_to_mail_drop,3107,0,0,0,0
Dec 8 2005,Melis A. '08,Play hardand then work hard!,http://mitadmissions.org/blogs/entry/play_hardand_then_work_hard,3108,0,0,0,0
Dec 8 2005,Bryan O. '09,Public Art Projects,http://mitadmissions.org/blogs/entry/public_art_projects,3108,0,0,0,0
Dec 8 2005,Matt McGann '00,Selection notes,http://mitadmissions.org/blogs/entry/selection_notes,3108,0,0,0,0
Dec 7 2005,Bryan O. '09,Feeling Energized,http://mitadmissions.org/blogs/entry/feeling_energized,3109,0,0,0,0
Dec 7 2005,Mollie B. '06,Rejoicing,http://mitadmissions.org/blogs/entry/rejoicing,3109,0,0,0,0
Dec 7 2005,Anthony R. '09,Language classes over IAP,http://mitadmissions.org/blogs/entry/language_classes_over_iap,3109,0,0,0,0
Dec 6 2005,Melis A. '08,Laurie Burns: Studying Triple-GEM foils,http://mitadmissions.org/blogs/entry/laurie_burns_studying_triplege,3110,0,0,0,0
Dec 6 2005,Sam M. '07,One and one and one is three,http://mitadmissions.org/blogs/entry/one_and_one_and_one_is_three,3110,0,0,0,0
Dec 6 2005,Bryan G. Nance,What I Have Learned From The Early Decision Process At MIT,http://mitadmissions.org/blogs/entry/what_i_have_learned_from_the_e,3110,0,0,0,0
Dec 6 2005,Anthony R. '09,We Wear Matching Hats,http://mitadmissions.org/blogs/entry/we_wear_matching_hats,3110,0,0,0,0
Dec 6 2005,Mitra L. '07,Vaccine Externalities,http://mitadmissions.org/blogs/entry/vaccine_externalities,3110,0,0,0,0
Dec 5 2005,Mollie B. '06,Careers in biology,http://mitadmissions.org/blogs/entry/careers_in_biology,3111,1,0,0,1
Dec 5 2005,Ben Jones,From The Midst Of Selection,http://mitadmissions.org/blogs/entry/from_the_midst_of_selection,3111,0,0,0,0
Dec 4 2005,Daniel Barkowitz,And Answers to More Questions,http://mitadmissions.org/blogs/entry/and_answers_to_more_questions,3112,0,0,0,0
Dec 4 2005,Daniel Barkowitz,Part 2 - Parent Contribution from Assets,http://mitadmissions.org/blogs/entry/part_2_parent_contribution_fro,3112,0,0,0,0
Dec 4 2005,Daniel Barkowitz,Part 1 (long delayed) - Parent Contribution from Income,http://mitadmissions.org/blogs/entry/part_1_long_delayed_parent_con,3112,0,0,0,0
Dec 4 2005,Laura N. '09,Let it snow,http://mitadmissions.org/blogs/entry/let_it_snow,3112,0,0,0,0
Dec 4 2005,Matt McGann '00,Selection: Day Three,http://mitadmissions.org/blogs/entry/selection_day_three,3112,0,0,0,0
Dec 4 2005,Bryan O. '09,So about those flip flops,http://mitadmissions.org/blogs/entry/so_about_those_flip_flops,3112,0,0,0,0
Dec 3 2005,Mitra L. '07,December Events,http://mitadmissions.org/blogs/entry/december_events,3113,0,0,0,0
Dec 3 2005,Sam M. '07,It was the blurst of times?,http://mitadmissions.org/blogs/entry/it_was_the_blurst_of_times,3113,0,0,0,0
Dec 3 2005,Anthony R. '09,Selection?,http://mitadmissions.org/blogs/entry/selection,3113,0,0,0,0
Dec 2 2005,Matt McGann '00,Selection begins,http://mitadmissions.org/blogs/entry/selection_begins,3114,0,0,0,0
Dec 1 2005,Sam M. '07,Im just curious as to why you keep invoking William Faulkner.,http://mitadmissions.org/blogs/entry/im_just_curious_as_to_why_you,3115,0,0,0,0
Dec 1 2005,Ben Jones,November Scores,http://mitadmissions.org/blogs/entry/november_scores,3115,0,0,0,0
Dec 1 2005,Matt McGann '00,Worlds Largest Collection of Brains,http://mitadmissions.org/blogs/entry/worlds_largest_collection_of_b,3115,0,0,0,0
Nov 30 2005,Mitra L. '07,NSUW Coffee Chat,http://mitadmissions.org/blogs/entry/nsuw_coffee_chat,3116,0,0,0,0
Nov 30 2005,Matt McGann '00,Reading folders,http://mitadmissions.org/blogs/entry/reading_folders,3116,0,0,0,0
Nov 30 2005,Bryan O. '09,No Flip Flops,http://mitadmissions.org/blogs/entry/no_flip_flops,3116,0,0,0,0
Nov 30 2005,Mollie B. '06,Life or something like it,http://mitadmissions.org/blogs/entry/life_or_something_like_it,3116,0,0,0,0
Nov 29 2005,Matt McGann '00,Random notes,http://mitadmissions.org/blogs/entry/random_notes,3117,0,0,0,0
Nov 28 2005,Melis A. '08,Boris Alexeev: Solving Graph Theory Problems,http://mitadmissions.org/blogs/entry/boris_alexeev_solving_graph_th,3118,0,0,0,0
Nov 27 2005,Jessie L. '07,Replying to questions and comments,http://mitadmissions.org/blogs/entry/replying_to_questions_and_comm,3119,0,0,0,0
Nov 27 2005,Sam M. '07,Essay-M,http://mitadmissions.org/blogs/entry/essaym,3119,1,1,0,2
Nov 26 2005,Mollie B. '06,Back in Cambridge,http://mitadmissions.org/blogs/entry/back_in_cambridge,3120,0,0,0,0
Nov 26 2005,Ben Jones,Checking In,http://mitadmissions.org/blogs/entry/checking_in,3120,0,0,0,0
Nov 25 2005,Matt McGann '00,Some notes for applicants,http://mitadmissions.org/blogs/entry/some_notes_for_applicants,3121,0,0,0,0
Nov 25 2005,Mitra L. '07,Yoga,http://mitadmissions.org/blogs/entry/yoga,3121,0,0,0,0
Nov 24 2005,Sam M. '07,The Decisive Battle,http://mitadmissions.org/blogs/entry/the_decisive_battle,3122,0,0,0,0
Nov 24 2005,Bryan O. '09,Happy Thanksgiving!,http://mitadmissions.org/blogs/entry/happy_thanksgiving_1,3122,0,0,0,0
Nov 23 2005,Laura N. '09,On my way,http://mitadmissions.org/blogs/entry/on_my_way,3123,0,0,0,0
Nov 22 2005,Sam M. '07,"Our loving, our friends, and our labor",http://mitadmissions.org/blogs/entry/our_loving_our_friends_and_our,3124,0,0,0,0
Nov 22 2005,Mitra L. '07,Some of the topics,http://mitadmissions.org/blogs/entry/some_of_the_topics,3124,0,0,0,0
Nov 21 2005,Mollie B. '06,Twas the week before Thanksgiving,http://mitadmissions.org/blogs/entry/twas_the_week_before_thanksgiv,3125,0,0,0,0
Nov 21 2005,Bryan O. '09,Its not every day,http://mitadmissions.org/blogs/entry/its_not_every_day,3125,0,0,0,0
Nov 21 2005,Sam M. '07,One wonderful day,http://mitadmissions.org/blogs/entry/one_wonderful_day,3125,0,0,0,0
Nov 21 2005,Matt McGann '00,In the News,http://mitadmissions.org/blogs/entry/in_the_news,3125,0,0,0,0
Nov 20 2005,Melis A. '08,Shaye Storm: Studying Extrasolar Planets,http://mitadmissions.org/blogs/entry/shaye_storm_studying_extrasola,3126,0,0,0,0
Nov 19 2005,Mitra L. '07,"See, I Am! (CI-M)",http://mitadmissions.org/blogs/entry/see_i_am_cim,3127,0,0,0,0
Nov 19 2005,Matt McGann '00,Some a capella,http://mitadmissions.org/blogs/entry/some_a_capella,3127,0,0,0,0
Nov 19 2005,Anthony R. '09,Asking for Directions,http://mitadmissions.org/blogs/entry/asking_for_directions,3127,0,0,0,0
Nov 19 2005,Jessie L. '07,I?TFP,http://mitadmissions.org/blogs/entry/itfp,3127,0,0,0,0
Nov 18 2005,Mollie B. '06,Lunch with Madam President,http://mitadmissions.org/blogs/entry/lunch_with_madam_president,3128,0,0,0,0
Nov 18 2005,Laura N. '09,Wangoballwime?,http://mitadmissions.org/blogs/entry/wangoballwime,3128,0,0,0,0
Nov 18 2005,Melis A. '08,"Ah, those inspirational Germans!",http://mitadmissions.org/blogs/entry/ah_those_inspirational_germans,3128,0,2,0,2
Nov 17 2005,Bryan O. '09,He-Who-Must-Not-Be-Named Returns,http://mitadmissions.org/blogs/entry/hewhomustnotbenamed_returns,3129,0,0,0,0
Nov 17 2005,Sam M. '07,Fixing a hole,http://mitadmissions.org/blogs/entry/fixing_a_hole,3129,0,0,0,0
Nov 16 2005,Mitra L. '07,MFA Boston,http://mitadmissions.org/blogs/entry/mfa_boston,3130,0,0,0,0
Nov 16 2005,Matt McGann '00,$100 Laptop Unveiled,http://mitadmissions.org/blogs/entry/100_laptop_unveiled,3130,1,2,0,3
Nov 16 2005,Bryan O. '09,Q&A: Round One,http://mitadmissions.org/blogs/entry/qa_round_one,3130,0,0,0,0
Nov 16 2005,Matt McGann '00,Mystery Hunt 2006 announced,http://mitadmissions.org/blogs/entry/mystery_hunt_2006_announced,3130,0,0,0,0
Nov 15 2005,Bryan O. '09,The Search Continues,http://mitadmissions.org/blogs/entry/the_search_continues,3131,0,0,0,0
Nov 14 2005,Laura N. '09,What did YOU do this weekend?,http://mitadmissions.org/blogs/entry/what_did_you_do_this_weekend,3132,0,0,0,0
Nov 14 2005,Mollie B. '06,Professor quotes,http://mitadmissions.org/blogs/entry/professor_quotes,3132,0,0,0,0
Nov 13 2005,Sam M. '07,Tribute,http://mitadmissions.org/blogs/entry/tribute,3133,0,0,0,0
Nov 13 2005,Jessie L. '07,Where are we going?,http://mitadmissions.org/blogs/entry/where_are_we_going,3133,0,0,0,0
Nov 13 2005,Ben Jones,"Bye Bye Weekends, See You In April",http://mitadmissions.org/blogs/entry/bye_bye_weekends_see_you_in_ap,3133,0,0,0,0
Nov 13 2005,Melis A. '08,Jugal Shah- Improving the technique of High Resolution Quantitative Autoradiography,http://mitadmissions.org/blogs/entry/jugal_shah_improving_the_techn,3133,0,0,0,0
Nov 13 2005,Laura N. '09,Spectacle,http://mitadmissions.org/blogs/entry/spectacle,3133,0,0,0,0
Nov 13 2005,Matt McGann '00,More About Reading,http://mitadmissions.org/blogs/entry/more_about_reading,3133,0,0,0,0
Nov 12 2005,Sam M. '07,"Not in our stars, but in ourselves",http://mitadmissions.org/blogs/entry/not_in_our_stars_but_in_oursel,3134,0,0,0,0
Nov 12 2005,Bryan O. '09,May the Force Be With You,http://mitadmissions.org/blogs/entry/may_the_force_be_with_you,3134,0,0,0,0
Nov 12 2005,Mitra L. '07,Leadership & Double Dare,http://mitadmissions.org/blogs/entry/leadership_double_dare,3134,0,0,0,0
Nov 10 2005,Sam M. '07,4,http://mitadmissions.org/blogs/entry/four_4,3136,0,0,0,0
Nov 10 2005,Matt McGann '00,The Reading Commences,http://mitadmissions.org/blogs/entry/the_reading_commences,3136,0,0,0,0
Nov 10 2005,Mollie B. '06,Quick and dirty,http://mitadmissions.org/blogs/entry/quick_and_dirty,3136,0,0,0,0
Nov 10 2005,Bryan O. '09,Unfold,http://mitadmissions.org/blogs/entry/unfold,3136,0,0,0,0
Nov 9 2005,Mitra L. '07,Womens Week 2005,http://mitadmissions.org/blogs/entry/womens_week_2005,3137,0,0,0,0
Nov 8 2005,Laura N. '09,Yo quiero,http://mitadmissions.org/blogs/entry/yo_quiero,3138,0,0,0,0
Nov 8 2005,Bryan G. Nance,Free-For-All Week!,http://mitadmissions.org/blogs/entry/freeforall_week,3138,0,0,0,0
Nov 8 2005,Ben Jones,Bens Fourth Semi-Annual Q&A,http://mitadmissions.org/blogs/entry/bens_fourth_semiannual_qa,3138,0,0,0,0
Nov 8 2005,Matt McGann '00,Spring Classes Online,http://mitadmissions.org/blogs/entry/spring_classes_online,3138,0,0,0,0
Nov 7 2005,Sam M. '07,Whats going on inside my head,http://mitadmissions.org/blogs/entry/whats_going_on_inside_my_head,3139,0,0,0,0
Nov 7 2005,Mollie B. '06,On sleep,http://mitadmissions.org/blogs/entry/on_sleep,3139,0,0,0,0
Nov 7 2005,Anthony R. '09,Another week?,http://mitadmissions.org/blogs/entry/another_week,3139,0,0,0,0
Nov 6 2005,Matt McGann '00,Admissions Blogs,http://mitadmissions.org/blogs/entry/admissions_blogs,3140,0,0,0,0
Nov 6 2005,Laura N. '09,Study Break!,http://mitadmissions.org/blogs/entry/study_break,3140,0,0,0,0
Nov 6 2005,Bryan O. '09,The Return of QBert,http://mitadmissions.org/blogs/entry/the_return_of_qbert,3140,0,0,0,0
Nov 5 2005,Matt McGann '00,"Leaves, Strawberries, Doors",http://mitadmissions.org/blogs/entry/leaves_strawberries_doors,3141,11,1,2,14
Nov 5 2005,Mitra L. '07,About Some Activities (ASA),http://mitadmissions.org/blogs/entry/about_some_activities_asa,3141,0,0,0,0
Nov 5 2005,Melis A. '08,Review of Shopgirl,http://mitadmissions.org/blogs/entry/review_of_shopgirl,3141,0,0,0,0
Nov 3 2005,Mollie B. '06,So done,http://mitadmissions.org/blogs/entry/so_done,3143,0,0,0,0
Nov 2 2005,Matt McGann '00,November Questions Omnibus 1,http://mitadmissions.org/blogs/entry/november_questions_omnibus_1,3144,0,0,0,0
Nov 2 2005,Ben Jones,Bens Third Semi-Annual Q&A,http://mitadmissions.org/blogs/entry/bens_third_semiannual_qa,3144,0,0,0,0
Nov 2 2005,Jessie L. '07,The return of photos to my blog!,http://mitadmissions.org/blogs/entry/the_return_of_photos_to_my_blo,3144,0,0,0,0
Nov 2 2005,Sam M. '07,Nothing beats a wet beaver!,http://mitadmissions.org/blogs/entry/nothing_beats_a_wet_beaver,3144,0,0,0,0
Nov 2 2005,Bryan O. '09,Trick or Treat!,http://mitadmissions.org/blogs/entry/trick_or_treat,3144,0,0,0,0
Nov 1 2005,Matt McGann '00,Teacher of the Year,http://mitadmissions.org/blogs/entry/teacher_of_the_year,3145,0,0,0,0
Nov 1 2005,Laura N. '09,Happy November 1st!,http://mitadmissions.org/blogs/entry/happy_november_1st,3145,0,0,0,0
Nov 1 2005,Mitra L. '07,We all campus for iCampus,http://mitadmissions.org/blogs/entry/we_all_campus_for_icampus,3145,0,0,0,0
Nov 1 2005,Sam M. '07,Temporary Band Entry Title,http://mitadmissions.org/blogs/entry/temporary_band_entry_title,3145,0,0,0,0
Oct 31 2005,Anthony R. '09,"So, youre applying to college.",http://mitadmissions.org/blogs/entry/so_youre_applying_to_college,3146,0,0,0,0
Oct 30 2005,Mitra L. '07,Glass Flowers,http://mitadmissions.org/blogs/entry/glass_flowers,3147,0,0,0,0
Oct 30 2005,Matt McGann '00,October Questions Omnibus 2,http://mitadmissions.org/blogs/entry/october_questions_omnibus_2,3147,0,0,0,0
Oct 30 2005,Laura N. '09,Application advice,http://mitadmissions.org/blogs/entry/application_advice,3147,0,0,0,0
Oct 30 2005,Mollie B. '06,Choice and the MIT lifestyle,http://mitadmissions.org/blogs/entry/choice_and_the_mit_lifestyle,3147,1,0,0,1
Oct 30 2005,Ben Jones,MyMIT Problems - EA Deadline Now 11/4,http://mitadmissions.org/blogs/entry/mymit_problems_ea_deadline_now,3147,0,0,0,0
Oct 30 2005,Sam M. '07,Hummingbird in a Cube of Ice,http://mitadmissions.org/blogs/entry/hummingbird_in_a_cube_of_ice,3147,0,0,0,0
Oct 30 2005,Laura N. '09,Small talk,http://mitadmissions.org/blogs/entry/small_talk,3147,0,0,0,0
Oct 30 2005,Daniel Barkowitz,Singing (again) in four part harmony.,http://mitadmissions.org/blogs/entry/singing_again_in_four_part_har,3147,0,0,0,0
Oct 29 2005,Melis A. '08,The First Snow of the Year!,http://mitadmissions.org/blogs/entry/the_first_snow_of_the_year,3148,0,0,0,0
Oct 29 2005,Bryan O. '09,The sky is falling!,http://mitadmissions.org/blogs/entry/the_sky_is_falling,3148,0,0,0,0
Oct 29 2005,Sam M. '07,Amsterdesk,http://mitadmissions.org/blogs/entry/amsterdesk,3148,0,0,0,0
Oct 28 2005,Ben Jones,Bens Second Semi-Annual Q&A,http://mitadmissions.org/blogs/entry/bens_second_semiannual_qa,3149,0,0,0,0
Oct 28 2005,Laura N. '09,Its just so effortless!,http://mitadmissions.org/blogs/entry/its_just_so_effortless,3149,0,0,0,0
Oct 28 2005,Daniel Barkowitz,October really is the cruelest month,http://mitadmissions.org/blogs/entry/october_really_is_the_cruelest,3149,0,0,0,0
Oct 27 2005,Mollie B. '06,An actual day in the life,http://mitadmissions.org/blogs/entry/an_actual_day_in_the_life,3150,0,0,0,0
Oct 27 2005,Matt McGann '00,No Child Gets Ahead?,http://mitadmissions.org/blogs/entry/no_child_gets_ahead,3150,0,0,0,0
Oct 27 2005,Bryan O. '09,"Back to Life, Back to Reality",http://mitadmissions.org/blogs/entry/back_to_life_back_to_reality,3150,0,0,0,0
Oct 27 2005,Melis A. '08,Anna Teytelman: Japanese Hip-Hop Extraordinaire!,http://mitadmissions.org/blogs/entry/anna_teytelman_japanese_hiphop,3150,0,0,0,0
Oct 26 2005,Mitra L. '07,PumpkiNerd Carving,http://mitadmissions.org/blogs/entry/pumpkinerd_carving,3151,0,0,0,0
Oct 26 2005,Sam M. '07,"Im a driver, Im a winner",http://mitadmissions.org/blogs/entry/im_a_driver_im_a_winner,3151,0,0,0,0
Oct 26 2005,mitblogs,Go White Sox!,http://mitadmissions.org/blogs/entry/go_white_sox,3151,0,0,0,0
Oct 26 2005,mitblogs,The Role You Play in the Admissions Process,http://mitadmissions.org/blogs/entry/the_role_you_play_in_the_admis,3151,0,0,0,0
Oct 25 2005,Matt McGann '00,More Odds & Ends,http://mitadmissions.org/blogs/entry/more_odds_ends,3152,0,0,0,0
Oct 25 2005,Mollie B. '06,I am dumb,http://mitadmissions.org/blogs/entry/i_am_dumb,3152,0,0,0,0
Oct 24 2005,Sam M. '07,Pommes et manus,http://mitadmissions.org/blogs/entry/pommes_et_manus,3153,0,0,0,0
Oct 24 2005,Mitra L. '07,Special October Events,http://mitadmissions.org/blogs/entry/special_october_events,3153,0,0,0,0
Oct 24 2005,Bryan O. '09,Dirty Little Secret?,http://mitadmissions.org/blogs/entry/dirty_little_secret,3153,0,0,0,0
Oct 23 2005,Anthony R. '09,A Week of Chocolate and Octagons,http://mitadmissions.org/blogs/entry/a_week_of_chocolate_and_octago,3154,0,0,0,0
Oct 23 2005,Matt McGann '00,When Disaster Strikes,http://mitadmissions.org/blogs/entry/when_disaster_strikes,3154,0,0,0,0
Oct 23 2005,Jessie L. '07,Questions and answers,http://mitadmissions.org/blogs/entry/questions_and_answers,3154,0,0,0,0
Oct 23 2005,Laura N. '09,What MIT students do on Friday nights,http://mitadmissions.org/blogs/entry/what_mit_students_do_on_friday,3154,0,0,0,0
Oct 22 2005,Sam M. '07,"Yes, eat all our shirts!",http://mitadmissions.org/blogs/entry/yes_eat_all_our_shirts,3155,11,4,2,17
Oct 21 2005,Melis A. '08,Tour of Novartis,http://mitadmissions.org/blogs/entry/tour_of_novartis,3156,0,0,0,0
Oct 21 2005,Bryan G. Nance,Ive Got 99 Problems Admissions Is Not One,http://mitadmissions.org/blogs/entry/ive_got_99_problems_admissions,3156,56,52,35,143
Oct 21 2005,Mollie B. '06,My mom is here!,http://mitadmissions.org/blogs/entry/my_mom_is_here1,3156,0,0,0,0
Oct 21 2005,Mollie B. '06,My mom is here!,http://mitadmissions.org/blogs/entry/my_mom_is_here,3156,0,0,0,0
Oct 20 2005,Sam M. '07,Time in a bottle.,http://mitadmissions.org/blogs/entry/time_in_a_bottle,3157,0,0,0,0
Oct 20 2005,Matt McGann '00,EA Interview Deadline,http://mitadmissions.org/blogs/entry/ea_interview_deadline,3157,0,0,0,0
Oct 20 2005,Ben Jones,Bens First Annual Q&A,http://mitadmissions.org/blogs/entry/bens_first_annual_qa,3157,0,0,0,0
Oct 19 2005,Ben Jones,MIT Professor Creates DEATH RAY!,http://mitadmissions.org/blogs/entry/mit_professor_creates_death_ra,3158,0,0,0,0
Oct 19 2005,Laura N. '09,Ruth says update your blog!,http://mitadmissions.org/blogs/entry/ruth_says_update_your_blog,3158,0,0,0,0
Oct 19 2005,Matt McGann '00,Supplemental material,http://mitadmissions.org/blogs/entry/supplemental_material,3158,0,0,0,0
Oct 18 2005,Jessie L. '07,"Hey look, Im famousor something",http://mitadmissions.org/blogs/entry/hey_look_im_famousor_something,3159,0,0,0,0
Oct 18 2005,Bryan O. '09,"I think I can, I think I can",http://mitadmissions.org/blogs/entry/i_think_i_can_i_think_i_can,3159,0,0,0,0
Oct 17 2005,Matt McGann '00,Autumn in New England,http://mitadmissions.org/blogs/entry/autumn_in_new_england,3160,0,0,0,0
Oct 17 2005,Mollie B. '06,A lot about course 9,http://mitadmissions.org/blogs/entry/a_lot_about_course_9,3160,0,0,0,0
Oct 17 2005,Laura N. '09,Yay for cheap stuff,http://mitadmissions.org/blogs/entry/yay_for_cheap_stuff,3160,0,0,0,0
Oct 16 2005,Anthony R. '09,"Friends, Carafes, and the Infinite Corridor",http://mitadmissions.org/blogs/entry/friends_carafes_and_the_infini,3161,0,0,0,0
Oct 15 2005,Matt McGann '00,Adventures in Math,http://mitadmissions.org/blogs/entry/adventures_in_math,3162,0,0,0,0
Oct 15 2005,Sam M. '07,No time for your stupid question.,http://mitadmissions.org/blogs/entry/no_time_for_your_stupid_questi,3162,0,1,0,1
Oct 14 2005,Bryan O. '09,Riddle Me This,http://mitadmissions.org/blogs/entry/riddle_me_this,3163,0,0,0,0
Oct 14 2005,Mitra L. '07,2005 Economics Nobel,http://mitadmissions.org/blogs/entry/2005_economics_nobel,3163,0,0,0,0
Oct 13 2005,Sam M. '07,Borne back ceaselessly into the past,http://mitadmissions.org/blogs/entry/borne_back_ceaselessly_into_th,3164,0,0,0,0
Oct 13 2005,Melis A. '08,Vivek Venkatachalam- Constructing a Very Low Temperature Scanning Tunneling Microscope,http://mitadmissions.org/blogs/entry/vivek_venkatachalam_constructi,3164,0,0,0,0
Oct 12 2005,Mollie B. '06,Tests of the non-standardized kind,http://mitadmissions.org/blogs/entry/tests_of_the_nonstandardized_k,3165,1,0,0,1
Oct 12 2005,Matt McGann '00,October Questions Omnibus 1,http://mitadmissions.org/blogs/entry/october_questions_omnibus_1,3165,0,0,0,0
Oct 12 2005,Stu Schmill '86,Advice On How To Approach Your Interview,http://mitadmissions.org/blogs/entry/advice_on_how_to_approach_your,3165,7,2,0,9
Oct 11 2005,Mitra L. '07,XC is Sexy,http://mitadmissions.org/blogs/entry/xc_is_sexy,3166,0,0,0,0
Oct 11 2005,Bryan O. '09,Faster than a speeding locomotive.,http://mitadmissions.org/blogs/entry/faster_than_a_speeding_locomot,3166,0,0,0,0
Oct 11 2005,Ben Jones,4 8 15 16 23 42,http://mitadmissions.org/blogs/entry/4_8_15_16_23_42,3166,0,0,0,0
Oct 11 2005,Bryan G. Nance,Open Forum Monday,http://mitadmissions.org/blogs/entry/open_forum_monday,3166,0,0,0,0
Oct 11 2005,Mollie B. '06,Long weekend,http://mitadmissions.org/blogs/entry/long_weekend,3166,0,0,0,0
Oct 10 2005,Sam M. '07,Library Battle: Harvard vs. MIT,http://mitadmissions.org/blogs/entry/library_battle_harvard_vs_mit,3167,0,0,0,0
Oct 10 2005,Jessie L. '07,"Structure and function, dorms and culture",http://mitadmissions.org/blogs/entry/structure_and_function_dorms_a,3167,0,1,0,1
Oct 9 2005,Melis A. '08,"Dishwashers, parents, space: what do these things have in common?",http://mitadmissions.org/blogs/entry/dishwashers_parents_space_what,3168,0,0,0,0
Oct 8 2005,Anthony R. '09,Even Waitresses Under 30 Call Me Sweetheart...,http://mitadmissions.org/blogs/entry/even_waitresses_under_30_call,3169,0,0,0,0
Oct 8 2005,Laura N. '09,College students do eat real food!,http://mitadmissions.org/blogs/entry/college_students_do_eat_real_f,3169,0,0,0,0
Oct 7 2005,Sam M. '07,TMI WRT MIT TLAs,http://mitadmissions.org/blogs/entry/tmi_wrt_mit_tlas,3170,0,0,0,0
Oct 7 2005,Mitra L. '07,Nightmarket,http://mitadmissions.org/blogs/entry/nightmarket,3170,0,0,0,0
Oct 7 2005,Mollie B. '06,"How to do everything wrong and still get into MIT, part deux",http://mitadmissions.org/blogs/entry/how_to_do_everything_wrong_and_1,3170,1,1,0,2
Oct 7 2005,Jessie L. '07,"Lies, damn lies, and statistics",http://mitadmissions.org/blogs/entry/lies_damn_lies_and_statistics,3170,3,4,4,11
Oct 7 2005,Daniel Barkowitz,"Myth #5: The more I get in scholarships from other places, the less my parents have to pay to MIT.",http://mitadmissions.org/blogs/entry/myth_5_the_more_i_get_in_schol,3170,0,4,0,4
Oct 7 2005,Daniel Barkowitz,Elephants on Parade,http://mitadmissions.org/blogs/entry/elephants_on_parade,3170,0,0,0,0
Oct 6 2005,Bryan O. '09,"Dear Mom, Vol. 1",http://mitadmissions.org/blogs/entry/dear_mom_vol_1,3171,0,0,0,0
Oct 6 2005,Laura N. '09,Tests @ MIT,http://mitadmissions.org/blogs/entry/tests_mit,3171,0,0,0,0
Oct 6 2005,Ben Jones,Elephants?,http://mitadmissions.org/blogs/entry/elephants,3171,0,0,0,0
Oct 6 2005,Sam M. '07,Spreading Santorum around MIT,http://mitadmissions.org/blogs/entry/spreading_santorum_around_mit,3171,0,0,0,0
Oct 5 2005,Ben Jones,Many Ways To Define The Best,http://mitadmissions.org/blogs/entry/many_ways_to_define_the_best,3172,66,38,24,128
Oct 5 2005,Melis A. '08,Bryan Owens: Developing bioreactors,http://mitadmissions.org/blogs/entry/bryan_owens_developing_bioreac,3172,0,0,0,0
Oct 5 2005,Sam M. '07,"I like to break a mental sweat, too.",http://mitadmissions.org/blogs/entry/i_like_to_break_a_mental_sweat,3172,0,0,0,0
Oct 5 2005,Matt McGann '00,Nobel Prize Week,http://mitadmissions.org/blogs/entry/nobel_prize_week,3172,0,0,0,0
Oct 5 2005,Bryan O. '09,MITs Newest Nobel Laureate,http://mitadmissions.org/blogs/entry/mits_newest_nobel_laureate,3172,0,0,0,0
Oct 5 2005,Mitra L. '07,Study Abroad Fair,http://mitadmissions.org/blogs/entry/study_abroad_fair,3172,0,0,0,0
Oct 4 2005,Mollie B. '06,Chicken with my head cut off,http://mitadmissions.org/blogs/entry/chicken_with_my_head_cut_off,3173,0,0,0,0
Oct 4 2005,Sam M. '07,Lie la lying down,http://mitadmissions.org/blogs/entry/lie_la_lying_down,3173,0,0,0,0
Oct 3 2005,Ben Jones,"Fall Travel Days 8,9,10,11,12: PA, NJ, and Home!",http://mitadmissions.org/blogs/entry/fall_travel_days_89101112_pa_n,3174,0,0,0,0
Oct 3 2005,Laura N. '09,Photojournalism,http://mitadmissions.org/blogs/entry/photojournalism,3174,0,0,0,0
Oct 2 2005,Jessie L. '07,Party pics,http://mitadmissions.org/blogs/entry/party_pics,3175,0,8,1,9
Oct 2 2005,Bryan O. '09,Can you patch me through to the blimp?,http://mitadmissions.org/blogs/entry/can_you_patch_me_through_to_th,3175,0,0,0,0
Oct 1 2005,Matt McGann '00,Quick update,http://mitadmissions.org/blogs/entry/quick_update_1,3176,0,0,0,0
Oct 1 2005,Anthony R. '09,"Youre 18, But You Arent Invincible",http://mitadmissions.org/blogs/entry/youre_18_but_you_arent_invinci,3176,0,0,0,0
Sep 30 2005,Mollie B. '06,Friday vacation,http://mitadmissions.org/blogs/entry/friday_vacation,3177,0,0,0,0
Sep 30 2005,Sam M. '07,More humanities than a humanities major,http://mitadmissions.org/blogs/entry/more_humanities_than_a_humanit,3177,0,0,0,0
Sep 30 2005,Bryan O. '09,And if I had a million dollars,http://mitadmissions.org/blogs/entry/and_if_i_had_a_million_dollars,3177,0,0,0,0
Sep 30 2005,Matt McGann '00,The real O.C.,http://mitadmissions.org/blogs/entry/the_real_oc,3177,0,0,0,0
Sep 29 2005,Mitra L. '07,ZBT Soiree,http://mitadmissions.org/blogs/entry/zbt_soiree,3178,0,0,0,0
Sep 28 2005,Bryan G. Nance,On Tour,http://mitadmissions.org/blogs/entry/on_tour,3179,0,0,0,0
Sep 28 2005,Matt McGann '00,Meeting FAQ,http://mitadmissions.org/blogs/entry/meeting_faq,3179,0,0,0,0
Sep 28 2005,Mollie B. '06,Professor accessibility,http://mitadmissions.org/blogs/entry/professor_accessibility,3179,0,0,0,0
Sep 27 2005,Sam M. '07,Question me an answer.,http://mitadmissions.org/blogs/entry/question_me_an_answer,3180,0,0,0,0
Sep 27 2005,Melis A. '08,MITs Undergraduate Research Journal: Get your work published!,http://mitadmissions.org/blogs/entry/mits_undergraduate_research_jo,3180,0,0,0,0
Sep 27 2005,Bryan O. '09,My Kind Of Party,http://mitadmissions.org/blogs/entry/my_kind_of_party,3180,0,0,0,0
Sep 26 2005,Mitra L. '07,UEA Internship Panel,http://mitadmissions.org/blogs/entry/uea_internship_panel,3181,0,0,0,0
Sep 26 2005,Ben Jones,Fall Travel Day 7: Philly,http://mitadmissions.org/blogs/entry/fall_travel_day_7_philly,3181,0,0,0,0
Sep 26 2005,Matt McGann '00,NACAC Conference,http://mitadmissions.org/blogs/entry/nacac_conference,3181,0,0,0,0
Sep 25 2005,Anthony R. '09,Party of One,http://mitadmissions.org/blogs/entry/party_of_one,3182,0,0,0,0
Sep 25 2005,Jessie L. '07,A week in the life,http://mitadmissions.org/blogs/entry/a_week_in_the_life,3182,0,0,0,0
Sep 25 2005,Laura N. '09,Q&A Part II,http://mitadmissions.org/blogs/entry/qa_part_ii,3182,0,0,0,0
Sep 25 2005,Mitra L. '07,Kresge Info Session,http://mitadmissions.org/blogs/entry/kresge_info_session,3182,0,0,0,0
Sep 24 2005,Mollie B. '06,Overnight Program,http://mitadmissions.org/blogs/entry/overnight_program,3183,0,2,0,2
Sep 24 2005,Ben Jones,"Fall Travel Days 4,5,6: NACAC Conference",http://mitadmissions.org/blogs/entry/fall_travel_days_456_nacac_con,3183,0,0,0,0
Sep 24 2005,Sam M. '07,Three cheers for the MIT Marching Band,http://mitadmissions.org/blogs/entry/three_cheers_for_the_mit_march,3183,0,0,0,0
Sep 24 2005,Bryan O. '09,Almost Only Counts in Horseshoes,http://mitadmissions.org/blogs/entry/almost_only_counts_in_horsesho,3183,0,0,0,0
Sep 24 2005,Melis A. '08,Laura Stonehill: Designing Italian Pedestrian Bridges,http://mitadmissions.org/blogs/entry/laura_stonehill_designing_ital,3183,0,0,0,0
Sep 23 2005,Daniel Barkowitz,Glass Pumpkins for Sale,http://mitadmissions.org/blogs/entry/glass_pumpkins_for_sale,3184,0,0,0,0
Sep 23 2005,Matt McGann '00,September Questions Omnibus 2,http://mitadmissions.org/blogs/entry/september_questions_omnibus_2,3184,0,0,0,0
Sep 22 2005,Sam M. '07,"See me, feel me, milq me, heal me",http://mitadmissions.org/blogs/entry/see_me_feel_me_milq_me_heal_me,3185,0,0,0,0
Sep 22 2005,Mollie B. '06,Odds and Ends,http://mitadmissions.org/blogs/entry/odds_and_ends,3185,0,0,0,0
Sep 22 2005,Daniel Barkowitz,Feeling lost again and the return of more questions answered,http://mitadmissions.org/blogs/entry/feeling_lost_again_and_the_ret,3185,0,0,0,0
Sep 21 2005,Laura N. '09,We even learn stuff here!,http://mitadmissions.org/blogs/entry/we_even_learn_stuff_here,3186,0,0,0,0
Sep 21 2005,Ben Jones,Fall Travel Days 2+3: Westchester County,http://mitadmissions.org/blogs/entry/fall_travel_days_23_westcheste,3186,0,0,0,0
Sep 21 2005,Matt McGann '00,More free stuff,http://mitadmissions.org/blogs/entry/more_free_stuff,3186,0,0,0,0
Sep 21 2005,Melis A. '08,Choosing between a career and motherhood,http://mitadmissions.org/blogs/entry/choosing_between_a_career_and,3186,0,0,0,0
Sep 20 2005,Anthony R. '09,Varied states of the basement,http://mitadmissions.org/blogs/entry/varied_states_of_the_basement,3187,0,0,0,0
Sep 20 2005,Bryan O. '09,Getting MISTI-fied,http://mitadmissions.org/blogs/entry/getting_mistified,3187,0,0,0,0
Sep 20 2005,Sam M. '07,MIT students do it all night.,http://mitadmissions.org/blogs/entry/mit_students_do_it_all_night,3187,0,0,0,0
Sep 20 2005,Mitra L. '07,The Week of Weeks,http://mitadmissions.org/blogs/entry/the_week_of_weeks,3187,0,0,0,0
Sep 20 2005,Matt McGann '00,Theyre not just regular artists,http://mitadmissions.org/blogs/entry/theyre_not_just_regular_artist,3187,0,0,0,0
Sep 19 2005,Ben Jones,Fall Travel Day 1: Hartford,http://mitadmissions.org/blogs/entry/fall_travel_day_1_hartford,3188,0,0,0,0
Sep 19 2005,Anthony R. '09,Its all about the numbers,http://mitadmissions.org/blogs/entry/its_all_about_the_numbers,3188,0,0,0,0
Sep 19 2005,Daniel Barkowitz,Myth #4: This financial aid thing is something my mom and dad need to worry about,http://mitadmissions.org/blogs/entry/myth_4_this_financial_aid_thin,3188,0,0,0,0
Sep 19 2005,Jessie L. '07,So many problem sets,http://mitadmissions.org/blogs/entry/so_many_problem_sets,3188,0,0,0,0
Sep 19 2005,Matt McGann '00,"Florida, complete",http://mitadmissions.org/blogs/entry/florida_complete,3188,0,0,0,0
Sep 18 2005,Mollie B. '06,Football home opener,http://mitadmissions.org/blogs/entry/football_home_opener,3189,0,0,0,0
Sep 18 2005,Laura N. '09,Questionable Views,http://mitadmissions.org/blogs/entry/questionable_views,3189,0,0,0,0
Sep 18 2005,Sam M. '07,"Ancient Chinese secret, eh?",http://mitadmissions.org/blogs/entry/ancient_chinese_secret_eh,3189,0,0,0,0
Sep 18 2005,Matt McGann '00,Better than a Ryan Cabrera poster,http://mitadmissions.org/blogs/entry/better_than_a_ryan_cabrera_pos,3189,0,0,0,0
Sep 17 2005,Daniel Barkowitz,Focus. Focus. (your attention needed)...,http://mitadmissions.org/blogs/entry/focus_focus_your_attention_nee,3190,0,0,0,0
Sep 17 2005,Melis A. '08,There is such a thing as a free event,http://mitadmissions.org/blogs/entry/there_is_such_a_thing_as_a_fre,3190,0,0,0,0
Sep 17 2005,Sam M. '07,You can get anything you want,http://mitadmissions.org/blogs/entry/you_can_get_anything_you_want,3190,0,0,0,0
Sep 16 2005,Bryan O. '09,We are the people in your neighborhood,http://mitadmissions.org/blogs/entry/we_are_the_people_in_your_neig,3191,0,0,0,0
Sep 16 2005,Mollie B. '06,To a mouse (or nineteen),http://mitadmissions.org/blogs/entry/to_a_mouse_or_nineteen,3191,0,0,0,0
Sep 16 2005,Daniel Barkowitz,Constitution Day,http://mitadmissions.org/blogs/entry/constitution_day,3191,0,0,0,0
Sep 15 2005,Matt McGann '00,September Questions Omnibus 1,http://mitadmissions.org/blogs/entry/september_questions_omnibus_1,3192,0,0,0,0
Sep 15 2005,Laura N. '09,Color by Numbers,http://mitadmissions.org/blogs/entry/color_by_numbers,3192,0,0,0,0
Sep 15 2005,Mitra L. '07,ClassesFall 05,http://mitadmissions.org/blogs/entry/classes_fall_05,3192,0,0,0,0
Sep 15 2005,Melis A. '08,Ming-fai Fong- Designing an intelligent walking toddler robot,http://mitadmissions.org/blogs/entry/mingfai_fong_designing_an_inte,3192,0,0,0,0
Sep 14 2005,Sam M. '07,Chicken Burrito for the Lab Rats Soul,http://mitadmissions.org/blogs/entry/chicken_burrito_for_the_lab_ra,3193,0,0,0,0
Sep 14 2005,Daniel Barkowitz,Myth #3: Need-based and full-need mean the same thing,http://mitadmissions.org/blogs/entry/myth_3_needbased_and_fullneed,3193,0,0,0,0
Sep 14 2005,Jessie L. '07,Hacks and meta-hacks,http://mitadmissions.org/blogs/entry/hacks_and_metahacks,3193,0,0,0,0
Sep 14 2005,mitblogs,First Post,http://mitadmissions.org/blogs/entry/first_post_1,3193,0,0,0,0
Sep 14 2005,Stu Schmill '86,First Post,http://mitadmissions.org/blogs/entry/first_post,3193,0,0,0,0
Sep 13 2005,Laura N. '09,No more physics,http://mitadmissions.org/blogs/entry/no_more_physics,3194,0,0,0,0
Sep 13 2005,Sam M. '07,"riverrun, past Eve and Adams",http://mitadmissions.org/blogs/entry/riverrun_past_eve_and_adams,3194,0,0,0,0
Sep 13 2005,Mitra L. '07,Marathon Sports,http://mitadmissions.org/blogs/entry/marathon_sports,3194,0,0,0,0
Sep 12 2005,Daniel Barkowitz,Myth #2: Merit is better than Need,http://mitadmissions.org/blogs/entry/myth_2_merit_is_better_than_ne,3195,0,0,0,0
Sep 12 2005,Mollie B. '06,Double diplomas,http://mitadmissions.org/blogs/entry/double_diplomas,3195,0,0,0,0
Sep 12 2005,Matt McGann '00,Bienvenidos a Miami,http://mitadmissions.org/blogs/entry/bienvenidos_a_miami,3195,0,0,0,0
Sep 12 2005,Ben Jones,Fall Travel,http://mitadmissions.org/blogs/entry/fall_travel,3195,0,0,0,0
Sep 11 2005,Anthony R. '09,Avoiding moonlight on an empty stomach,http://mitadmissions.org/blogs/entry/avoiding_moonlight_on_an_empty,3196,0,0,0,0
Sep 11 2005,Jessie L. '07,Conspiracy and intrigue,http://mitadmissions.org/blogs/entry/conspiracy_and_intrigue,3196,0,0,0,0
Sep 11 2005,Sam M. '07,A way a lone a last a loved a long the,http://mitadmissions.org/blogs/entry/a_way_a_lone_a_last_a_loved_a,3196,1,0,0,1
Sep 10 2005,Matt McGann '00,The O.C.,http://mitadmissions.org/blogs/entry/the_oc,3197,0,0,0,0
Sep 9 2005,Bryan G. Nance,You Make The Call,http://mitadmissions.org/blogs/entry/you_make_the_call,3198,0,0,0,0
Sep 9 2005,Jessie L. '07,I have classes,http://mitadmissions.org/blogs/entry/i_have_classes,3198,0,0,0,0
Sep 8 2005,Mitra L. '07,Boston Fun,http://mitadmissions.org/blogs/entry/boston_fun,3199,0,0,0,0
Sep 8 2005,Anthony R. '09,Do you have class?,http://mitadmissions.org/blogs/entry/do_you_have_class,3199,0,0,0,0
Sep 8 2005,Sam M. '07,"You stay classy, Sam TA, go!",http://mitadmissions.org/blogs/entry/you_stay_classy_sam_ta_go,3199,0,0,0,0
Sep 8 2005,Bryan O. '09,Let the Rush Begin,http://mitadmissions.org/blogs/entry/let_the_rush_begin,3199,0,0,0,0
Sep 8 2005,Matt McGann '00,First day of classes,http://mitadmissions.org/blogs/entry/first_day_of_classes,3199,0,0,0,0
Sep 7 2005,Mollie B. '06,Schools in,http://mitadmissions.org/blogs/entry/schools_in,3200,0,0,0,0
Sep 7 2005,Melis A. '08,UROP Deadlines and Openings,http://mitadmissions.org/blogs/entry/urop_deadlines_and_openings,3200,0,0,0,0
Sep 7 2005,Daniel Barkowitz,Katrina,http://mitadmissions.org/blogs/entry/katrina_1,3200,0,0,0,0
Sep 7 2005,Bryan O. '09,"Welcome Back, Kotter",http://mitadmissions.org/blogs/entry/welcome_back_kotter,3200,0,0,0,0
Sep 6 2005,Matt McGann '00,Activities Midway,http://mitadmissions.org/blogs/entry/activities_midway,3201,0,0,0,0
Sep 6 2005,Laura N. '09,Fun with Legos,http://mitadmissions.org/blogs/entry/fun_with_legos,3201,0,4,0,4
Sep 6 2005,Sam M. '07,A thousand million questions,http://mitadmissions.org/blogs/entry/a_thousand_million_questions,3201,0,0,0,0
Sep 6 2005,Melis A. '08,Back and ready for action!,http://mitadmissions.org/blogs/entry/back_and_ready_for_action,3201,0,0,0,0
Sep 5 2005,Matt McGann '00,MIT Regional Meetings begin,http://mitadmissions.org/blogs/entry/mit_regional_meetings_begin,3202,0,0,0,0
Sep 5 2005,Mollie B. '06,"Finally, a free minute",http://mitadmissions.org/blogs/entry/finally_a_free_minute,3202,0,0,0,0
Sep 5 2005,Sam M. '07,Cool running,http://mitadmissions.org/blogs/entry/cool_running,3202,0,0,0,0
Sep 4 2005,Anthony R. '09,"Welcome to college, Kid.",http://mitadmissions.org/blogs/entry/welcome_to_college_kid,3203,0,0,0,0
Sep 4 2005,Jessie L. '07,Finding heritage at MIT,http://mitadmissions.org/blogs/entry/finding_heritage_at_mit,3203,0,0,0,0
Sep 4 2005,Bryan O. '09,Orientation Wrap-Up,http://mitadmissions.org/blogs/entry/orientation_wrapup,3203,0,0,0,0
Sep 3 2005,Sam M. '07,Every square is a rectangle,http://mitadmissions.org/blogs/entry/every_square_is_a_rectangle,3204,0,0,0,0
Sep 3 2005,Mitra L. '07,Carnival,http://mitadmissions.org/blogs/entry/carnival,3204,0,0,0,0
Sep 2 2005,Matt McGann '00,Hurricane Katrina,http://mitadmissions.org/blogs/entry/hurricane_katrina,3205,0,0,0,0
Sep 2 2005,Jessie L. '07,Dorm Rush and Hall Rush,http://mitadmissions.org/blogs/entry/dorm_rush_and_hall_rush,3205,0,0,0,0
Sep 2 2005,Laura N. '09,Power Tools at 2 AM,http://mitadmissions.org/blogs/entry/power_tools_at_2_am,3205,0,0,0,0
Sep 2 2005,Sam M. '07,Friday Afternoon Props,http://mitadmissions.org/blogs/entry/friday_afternoon_props,3205,0,0,0,0
Sep 2 2005,Ben Jones,Katrina,http://mitadmissions.org/blogs/entry/katrina,3205,0,0,0,0
Sep 2 2005,Bryan O. '09,puzzled again?,http://mitadmissions.org/blogs/entry/puzzled_again,3205,0,0,0,0
Sep 1 2005,Mollie B. '06,"Lies, Damned Lies, and Statistics",http://mitadmissions.org/blogs/entry/lies_damned_lies_and_statistic,3206,0,0,0,0
Aug 31 2005,Bryan O. '09,REX continued,http://mitadmissions.org/blogs/entry/rex_continued,3207,0,0,0,0
Aug 31 2005,Sam M. '07,"Rush, rush",http://mitadmissions.org/blogs/entry/rush_rush,3207,0,0,0,0
Aug 31 2005,Matt McGann '00,5 years out,http://mitadmissions.org/blogs/entry/5_years_out,3207,0,0,0,0
Aug 30 2005,Mitra L. '07,CityDays and ClayNights,http://mitadmissions.org/blogs/entry/citydays_and_claynights,3208,0,0,0,0
Aug 30 2005,Sam M. '07,Livin La Vida PRoCa,http://mitadmissions.org/blogs/entry/livin_la_vida_proca,3208,0,0,0,0
Aug 29 2005,Bryan O. '09,miT-REX,http://mitadmissions.org/blogs/entry/mitrex,3209,0,0,0,0
Aug 29 2005,Jessie L. '07,Things to do before you graduate,http://mitadmissions.org/blogs/entry/things_to_do_before_you_gradua,3209,0,0,0,0
Aug 29 2005,Daniel Barkowitz,Loan Note Signing Sessions,http://mitadmissions.org/blogs/entry/loan_note_signing_sessions,3209,0,0,0,0
Aug 29 2005,Mollie B. '06,Belonging,http://mitadmissions.org/blogs/entry/belonging,3209,0,0,0,0
Aug 29 2005,Matt McGann '00,August Questions Omnibus 2,http://mitadmissions.org/blogs/entry/august_questions_omnibus_2,3209,0,0,0,0
Aug 28 2005,Anthony R. '09,Leaving home,http://mitadmissions.org/blogs/entry/leaving_home,3210,0,0,0,0
Aug 27 2005,Bryan O. '09,how to spend a summer,http://mitadmissions.org/blogs/entry/how_to_spend_a_summer,3211,0,0,0,0
Aug 27 2005,Sam M. '07,An Overture to the Commencement of a Very Rigid Journey,http://mitadmissions.org/blogs/entry/an_overture_to_the_commencemen,3211,0,0,0,0
Aug 27 2005,Daniel Barkowitz,"Myth #1: On my Admissions application, I shouldnt say I plan on applying for financial aid",http://mitadmissions.org/blogs/entry/myth_1_on_my_admissions_applic,3211,0,0,0,0
Aug 26 2005,Daniel Barkowitz,T minus 10 and counting,http://mitadmissions.org/blogs/entry/t_minus_10_and_counting,3212,0,0,0,0
Aug 26 2005,Melis A. '08,Ready for some tennis?,http://mitadmissions.org/blogs/entry/ready_for_some_tennis,3212,0,0,0,0
Aug 26 2005,Sam M. '07,"Symphony 9, Op. 95 From the New Blog",http://mitadmissions.org/blogs/entry/symphony_9_op_95_from_the_new,3212,0,0,0,0
Aug 26 2005,Mitra L. '07,Can You Become,http://mitadmissions.org/blogs/entry/can_you_become,3212,0,0,0,0
Aug 26 2005,Bryan O. '09,fpop-ing,http://mitadmissions.org/blogs/entry/fpoping,3212,0,0,0,0
Aug 25 2005,Mollie B. '06,DOFMH,http://mitadmissions.org/blogs/entry/dofmh,3213,0,0,0,0
Aug 25 2005,Matt McGann '00,Meet the Admissions Officers: Stu Schmill 86,http://mitadmissions.org/blogs/entry/meet_the_admissions_officers_s,3213,0,0,0,0
Aug 25 2005,Jessie L. '07,Images of Rush preparation,http://mitadmissions.org/blogs/entry/images_of_rush_preparation,3213,0,0,0,0
Aug 24 2005,Matt McGann '00,Victorian Literature?,http://mitadmissions.org/blogs/entry/victorian_literature,3214,0,0,0,0
Aug 24 2005,Ben Jones,"Scenes From Admissions, Round Two",http://mitadmissions.org/blogs/entry/scenes_from_admissions_round_t,3214,0,0,0,0
Aug 24 2005,Bryan G. Nance,US News & World Report Just Save Your Wrist Watch.,http://mitadmissions.org/blogs/entry/us_news_world_report_just_save,3214,0,0,0,0
Aug 24 2005,Bryan O. '09,it really is beginning,http://mitadmissions.org/blogs/entry/it_really_is_beginning,3214,0,0,0,0
Aug 22 2005,Matt McGann '00,Testing requirements FAQ,http://mitadmissions.org/blogs/entry/testing_requirements_faq,3216,1,1,0,2
Aug 22 2005,Laura N. '09,I AM CONNECTED!,http://mitadmissions.org/blogs/entry/i_am_connected,3216,0,0,0,0
Aug 22 2005,Mollie B. '06,I am a hapless klutz,http://mitadmissions.org/blogs/entry/i_am_a_hapless_klutz,3216,0,0,0,0
Aug 22 2005,Daniel Barkowitz,MIT Number One in the College Rankings,http://mitadmissions.org/blogs/entry/mit_number_one_in_the_college,3216,0,0,0,0
Aug 22 2005,Jessie L. '07,And its all beginning,http://mitadmissions.org/blogs/entry/and_its_all_beginning,3216,0,0,0,0
Aug 21 2005,Bryan O. '09,turn the dial to 88.1,http://mitadmissions.org/blogs/entry/turn_the_dial_to_881,3217,0,0,0,0
Aug 20 2005,Melis A. '08,Emily Levesque- How megastars evolve,http://mitadmissions.org/blogs/entry/emily_levesque_how_megastars_e,3218,0,0,0,0
Aug 19 2005,Sam M. '07,My life in the bush of ghosts,http://mitadmissions.org/blogs/entry/my_life_in_the_bush_of_ghosts,3219,0,0,0,0
Aug 19 2005,Matt McGann '00,Meet the Admissions Officers: Mikey Yang 05,http://mitadmissions.org/blogs/entry/meet_the_admissions_officers_m_2,3219,0,0,0,0
Aug 19 2005,Jessie L. '07,Answers to some questions,http://mitadmissions.org/blogs/entry/answers_to_some_questions,3219,0,0,0,0
Aug 18 2005,Laura N. '09,Advising Folders!,http://mitadmissions.org/blogs/entry/advising_folders,3220,0,0,0,0
Aug 18 2005,Matt McGann '00,August Questions Omnibus 1,http://mitadmissions.org/blogs/entry/august_questions_omnibus_1,3220,0,0,0,0
Aug 18 2005,Mollie B. '06,Schedules are up!,http://mitadmissions.org/blogs/entry/schedules_are_up,3220,0,0,0,0
Aug 18 2005,Mitra L. '07,An Interview about the Interview,http://mitadmissions.org/blogs/entry/an_interview_about_the_intervi,3220,0,0,0,0
Aug 18 2005,Sam M. '07,Railroad reading,http://mitadmissions.org/blogs/entry/railroad_reading,3220,0,0,0,0
Aug 18 2005,Bryan O. '09,the runaround,http://mitadmissions.org/blogs/entry/the_runaround,3220,0,0,0,0
Aug 18 2005,Anthony R. '09,"Chasing Roots, Part One",http://mitadmissions.org/blogs/entry/chasing_roots_part_one,3220,0,0,0,0
Aug 17 2005,Sam M. '07,Is this the real life?,http://mitadmissions.org/blogs/entry/is_this_the_real_life,3221,0,0,0,0
Aug 16 2005,Bryan G. Nance,Should I include my ethnicity on the MIT Application?,http://mitadmissions.org/blogs/entry/should_i_include_my_ethnicity,3222,0,0,0,0
Aug 16 2005,Sam M. '07,A waffle house is not a waffle home,http://mitadmissions.org/blogs/entry/a_waffle_house_is_not_a_waffle,3222,0,0,0,0
Aug 16 2005,Bryan O. '09,bad vision,http://mitadmissions.org/blogs/entry/bad_vision,3222,0,0,0,0
Aug 15 2005,Matt McGann '00,Open Sesame,http://mitadmissions.org/blogs/entry/open_sesame,3223,0,0,0,0
Aug 15 2005,Sam M. '07,Train in vain,http://mitadmissions.org/blogs/entry/train_in_vain,3223,0,0,0,0
Aug 15 2005,Mollie B. '06,Im a believer,http://mitadmissions.org/blogs/entry/im_a_believer,3223,0,0,0,0
Aug 15 2005,Jessie L. '07,Come together (and eat),http://mitadmissions.org/blogs/entry/come_together_and_eat,3223,0,0,0,0
Aug 14 2005,Matt McGann '00,"Typhoon, Wedding",http://mitadmissions.org/blogs/entry/typhoon_wedding,3224,0,0,0,0
Aug 14 2005,Mollie B. '06,"Come in, were open",http://mitadmissions.org/blogs/entry/come_in_were_open,3224,0,0,0,0
Aug 13 2005,Mitra L. '07,"Pre-med, Everybodys Best Friend",http://mitadmissions.org/blogs/entry/premed_everybodys_best_friend,3225,0,0,0,0
Aug 13 2005,Sam M. '07,Living in the Past,http://mitadmissions.org/blogs/entry/living_in_the_past,3225,0,0,0,0
Aug 13 2005,Melis A. '08,The End of SURFing at NIST,http://mitadmissions.org/blogs/entry/the_end_of_surfing_at_nist,3225,0,0,0,0
Aug 13 2005,Jessie L. '07,Pursuing multiple fields,http://mitadmissions.org/blogs/entry/pursuing_multiple_fields,3225,0,0,0,0
Aug 11 2005,Sam M. '07,Paint Work VII,http://mitadmissions.org/blogs/entry/paint_work_vii,3227,0,0,0,0
Aug 11 2005,Matt McGann '00,MIT Dating Research,http://mitadmissions.org/blogs/entry/mit_dating_research,3227,0,0,0,0
Aug 11 2005,Bryan G. Nance,No Good Deed Goes Unpunished,http://mitadmissions.org/blogs/entry/no_good_deed_goes_unpunished,3227,0,0,0,0
Aug 10 2005,Mollie B. '06,Summertime and the living is slightly less difficult than usual,http://mitadmissions.org/blogs/entry/summertime_and_the_living_is_s,3228,0,0,0,0
Aug 10 2005,Matt McGann '00,Home!,http://mitadmissions.org/blogs/entry/home,3228,0,0,0,0
Aug 10 2005,Ben Jones,Where Weve Been And Where Were Going,http://mitadmissions.org/blogs/entry/where_weve_been_and_where_were,3228,0,0,0,0
Aug 10 2005,Sam M. '07,Dig if you will a picture.,http://mitadmissions.org/blogs/entry/dig_if_you_will_a_picture,3228,0,0,0,0
Aug 10 2005,Bryan O. '09,Goldilocks and the n HASS classes,http://mitadmissions.org/blogs/entry/goldilocks_and_the_n_hass_clas,3228,0,0,0,0
Aug 9 2005,Mitra L. '07,Dora the Explorer,http://mitadmissions.org/blogs/entry/dora_the_explorer,3229,0,0,0,0
Aug 9 2005,Anthony R. '09,"Breakfast in Paris, Lunch in Geneva, Dinner in Milan",http://mitadmissions.org/blogs/entry/breakfast_in_paris_lunch_in_ge,3229,0,0,0,0
Aug 9 2005,Bryan O. '09,jetsetting,http://mitadmissions.org/blogs/entry/jetsetting,3229,0,0,0,0
Aug 8 2005,Mollie B. '06,Saturday at the water park,http://mitadmissions.org/blogs/entry/saturday_at_the_water_park,3230,0,0,0,0
Aug 8 2005,Matt McGann '00,Meet the Admissions Officers: Mari McQuaid,http://mitadmissions.org/blogs/entry/meet_the_admissions_officers_m_1,3230,0,0,0,0
Aug 8 2005,Sam M. '07,Paint Work I,http://mitadmissions.org/blogs/entry/paint_work_i,3230,0,0,0,0
Aug 8 2005,Jessie L. '07,My Old Kentucky Home,http://mitadmissions.org/blogs/entry/my_old_kentucky_home,3230,0,0,0,0
Aug 8 2005,Bryan O. '09,Solution: Are we going to win?,http://mitadmissions.org/blogs/entry/solution_are_we_going_to_win,3230,0,0,0,0
Aug 7 2005,Melis A. '08,Jenny Hu- Adapting to Artifical Gravity,http://mitadmissions.org/blogs/entry/jenny_hu_adapting_to_artifical,3231,0,0,0,0
Aug 7 2005,Sam M. '07,What pretty hair,http://mitadmissions.org/blogs/entry/what_pretty_hair,3231,0,0,0,0
Aug 6 2005,Daniel Barkowitz,Cinquains,http://mitadmissions.org/blogs/entry/cinquains,3232,0,0,0,0
Aug 5 2005,Mollie B. '06,More on food,http://mitadmissions.org/blogs/entry/more_on_food,3233,0,0,0,0
Aug 5 2005,Matt McGann '00,First Blogiversary,http://mitadmissions.org/blogs/entry/first_blogiversary,3233,0,0,0,0
Aug 5 2005,Mitra L. '07,Lets Get Physical,http://mitadmissions.org/blogs/entry/lets_get_physical,3233,0,0,0,0
Aug 5 2005,Sam M. '07,Power of suggestion,http://mitadmissions.org/blogs/entry/power_of_suggestion,3233,0,0,0,0
Aug 5 2005,Bryan O. '09,Puzzle: Are we going to win?,http://mitadmissions.org/blogs/entry/puzzle_are_we_going_to_win,3233,0,0,0,0
Aug 4 2005,Sam M. '07,"Pop quiz, Viktor",http://mitadmissions.org/blogs/entry/pop_quiz_viktor,3234,0,0,0,0
Aug 4 2005,Bryan O. '09,optical illusions,http://mitadmissions.org/blogs/entry/optical_illusions,3234,0,0,0,0
Aug 3 2005,Matt McGann '00,Meet the Admissions Officers: Jenny Rifken,http://mitadmissions.org/blogs/entry/meet_the_admissions_officers_j,3235,0,0,0,0
Aug 3 2005,Melis A. '08,A little bit about me and my trip to La Republica Dominicana,http://mitadmissions.org/blogs/entry/a_little_bit_about_me_and_my_t,3235,0,0,0,0
Aug 3 2005,Sam M. '07,Boston Calling,http://mitadmissions.org/blogs/entry/boston_calling,3235,0,0,0,0
Aug 3 2005,Jessie L. '07,Venturing to far living groups,http://mitadmissions.org/blogs/entry/venturing_to_far_living_groups,3235,0,0,0,0
Aug 2 2005,Laura N. '09,Save a tree,http://mitadmissions.org/blogs/entry/save_a_tree,3236,0,0,0,0
Aug 2 2005,Ben Jones,Want To Play Music @ MIT?,http://mitadmissions.org/blogs/entry/want_to_play_music_mit,3236,0,0,0,0
Aug 2 2005,Melis A. '08,Sid Puram - Polymer Microspheres,http://mitadmissions.org/blogs/entry/sid_puram_polymer_microspheres,3236,0,0,0,0
Aug 2 2005,Mitra L. '07,Meliss UROP Blog,http://mitadmissions.org/blogs/entry/meliss_urop_blog,3236,0,0,0,0
Aug 2 2005,Bryan O. '09,Puzzled Solution,http://mitadmissions.org/blogs/entry/puzzled_solution,3236,0,0,0,0
Aug 1 2005,Sam M. '07,Beauty and the Geek,http://mitadmissions.org/blogs/entry/beauty_and_the_geek,3237,0,0,0,0
Aug 1 2005,Mollie B. '06,Tofu corndogs and low-fat ice cream,http://mitadmissions.org/blogs/entry/tofu_corndogs_and_lowfat_ice_c,3237,0,0,0,0
Aug 1 2005,Matt McGann '00,Meet the Admissions Officers: Ben Jones,http://mitadmissions.org/blogs/entry/meet_the_admissions_officers_b_1,3237,0,0,0,0
Jul 31 2005,Sam M. '07,Sun off a beach,http://mitadmissions.org/blogs/entry/sun_off_a_beach,3238,0,0,0,0
Jul 30 2005,Sam M. '07,I started a joke,http://mitadmissions.org/blogs/entry/i_started_a_joke,3239,0,0,0,0
Jul 29 2005,Anthony R. '09,Hi from Cambridge,http://mitadmissions.org/blogs/entry/hi_from_cambridge,3240,0,0,0,0
Jul 29 2005,Mitra L. '07,Reek Week,http://mitadmissions.org/blogs/entry/reek_week,3240,0,0,0,0
Jul 29 2005,Jessie L. '07,The middle days of the week,http://mitadmissions.org/blogs/entry/the_middle_days_of_the_week,3240,0,0,0,0
Jul 29 2005,Matt McGann '00,"Doogie Howser, et al.",http://mitadmissions.org/blogs/entry/doogie_howser_et_al,3240,0,0,0,0
Jul 29 2005,Ben Jones,Im A Famous Rockstar,http://mitadmissions.org/blogs/entry/im_a_famous_rockstar,3240,0,0,0,0
Jul 29 2005,Bryan O. '09,Puzzled,http://mitadmissions.org/blogs/entry/puzzled,3240,0,0,0,0
Jul 28 2005,Mollie B. '06,An MIT FAQ,http://mitadmissions.org/blogs/entry/an_mit_faq,3241,1,0,0,1
Jul 28 2005,Daniel Barkowitz,Wheres George and Where Are You From?,http://mitadmissions.org/blogs/entry/wheres_george_and_where_are_yo,3241,0,0,0,0
Jul 27 2005,Sam M. '07,I love Miu more than ice cream.,http://mitadmissions.org/blogs/entry/i_love_miu_more_than_ice_cream,3242,0,0,0,0
Jul 27 2005,Matt McGann '00,Meet the Admissions Officers: Bryan Nance,http://mitadmissions.org/blogs/entry/meet_the_admissions_officers_b,3242,0,0,0,0
Jul 27 2005,Melis A. '08,Issel Lim: IBD Research,http://mitadmissions.org/blogs/entry/issel_lim_ibd_research,3242,0,0,0,0
Jul 27 2005,Jessie L. '07,Temp assignments and cautionary tales,http://mitadmissions.org/blogs/entry/temp_assignments_and_cautionar,3242,0,0,0,0
Jul 27 2005,Bryan O. '09,The Wheels on the Bus Go Round And Round,http://mitadmissions.org/blogs/entry/the_wheels_on_the_bus_go_round,3242,0,0,0,0
Jul 27 2005,Mollie B. '06,"Sue me, Im a multicellular organism snob",http://mitadmissions.org/blogs/entry/sue_me_im_a_multicellular_orga,3242,0,0,0,0
Jul 26 2005,Sam M. '07,Reactors are my friends.,http://mitadmissions.org/blogs/entry/reactors_are_my_friends,3243,0,0,0,0
Jul 26 2005,Mitra L. '07,You Cant Make MIT Love You If You Dont,http://mitadmissions.org/blogs/entry/you_cant_make_mit_love_you_if,3243,0,0,0,0
Jul 26 2005,Bryan O. '09,Rewind the Tape,http://mitadmissions.org/blogs/entry/rewind_the_tape,3243,0,0,0,0
Jul 26 2005,Jessie L. '07,"Classy celebration, 5E-style",http://mitadmissions.org/blogs/entry/classy_celebration_5estyle,3243,0,0,0,0
Jul 25 2005,Matt McGann '00,Hometown Heroes,http://mitadmissions.org/blogs/entry/hometown_heroes,3244,0,0,0,0
Jul 25 2005,Laura N. '09,And the Lottery Says..,http://mitadmissions.org/blogs/entry/and_the_lottery_says,3244,0,0,0,0
Jul 25 2005,Sam M. '07,This is wondrous strange.,http://mitadmissions.org/blogs/entry/this_is_wondrous_strange,3244,0,0,0,0
Jul 24 2005,Bryan O. '09,whats in a name,http://mitadmissions.org/blogs/entry/whats_in_a_name,3245,0,0,0,0
Jul 23 2005,Sam M. '07,Im only happy when it rains.,http://mitadmissions.org/blogs/entry/im_only_happy_when_it_rains,3246,0,0,0,0
Jul 23 2005,Jessie L. '07,Nightswimming,http://mitadmissions.org/blogs/entry/nightswimming,3246,0,0,0,0
Jul 23 2005,Mollie B. '06,Opening doors,http://mitadmissions.org/blogs/entry/opening_doors,3246,0,0,0,0
Jul 22 2005,Sam M. '07,Somebody Else,http://mitadmissions.org/blogs/entry/somebody_else,3247,0,0,0,0
Jul 22 2005,Bryan O. '09,Shall We Dance?,http://mitadmissions.org/blogs/entry/shall_we_dance,3247,0,0,0,0
Jul 21 2005,Daniel Barkowitz,"One from Column A, and One from Column B",http://mitadmissions.org/blogs/entry/one_from_column_a_and_one_from,3248,0,0,0,0
Jul 21 2005,Sam M. '07,"Please, Mr. Postman",http://mitadmissions.org/blogs/entry/please_mr_postman,3248,0,0,0,0
Jul 20 2005,Melis A. '08,UROP 101 - The Intro Entry,http://mitadmissions.org/blogs/entry/urop_101_the_intro_entry,3249,0,0,0,0
Jul 20 2005,Jessie L. '07,Cool Classes,http://mitadmissions.org/blogs/entry/cool_classes,3249,0,0,0,0
Jul 20 2005,Mitra L. '07,Western Union,http://mitadmissions.org/blogs/entry/western_union,3249,0,0,0,0
Jul 20 2005,Matt McGann '00,Off to Southeast Asia,http://mitadmissions.org/blogs/entry/off_to_southeast_asia,3249,0,0,0,0
Jul 20 2005,Bryan O. '09,Thats one small step for man; one giant leap for mankind,http://mitadmissions.org/blogs/entry/thats_one_small_step_for_man_o,3249,0,0,0,0
Jul 19 2005,Anthony R. '09,Pardon my French!,http://mitadmissions.org/blogs/entry/pardon_my_french,3250,1,0,0,1
Jul 19 2005,Sam M. '07,Kick to the limit!,http://mitadmissions.org/blogs/entry/kick_to_the_limit,3250,0,0,0,0
Jul 19 2005,Mollie B. '06,"GRE, Boston love, and loose ends from last time",http://mitadmissions.org/blogs/entry/gre_boston_love_and_loose_ends,3250,0,0,0,0
Jul 19 2005,Matt McGann '00,MIT Central Meetings,http://mitadmissions.org/blogs/entry/mit_central_meetings,3250,0,0,0,0
Jul 19 2005,Ben Jones,Scenes From Admissions Round One,http://mitadmissions.org/blogs/entry/scenes_from_admissions_round_o,3250,0,0,0,0
Jul 18 2005,Bryan O. '09,The Finalists,http://mitadmissions.org/blogs/entry/the_finalists,3251,0,0,0,0
Jul 18 2005,Laura N. '09,THATS RIGHT!,http://mitadmissions.org/blogs/entry/thats_right,3251,0,0,0,0
Jul 18 2005,Sam M. '07,You dont know what a robot is?,http://mitadmissions.org/blogs/entry/you_dont_know_what_a_robot_is,3251,0,0,0,0
Jul 18 2005,Matt McGann '00,USA Wins 2nd in International Math Olympiad,http://mitadmissions.org/blogs/entry/usa_wins_2nd_in_international,3251,1,0,0,1
Jul 17 2005,Mitra L. '07,The Proposal,http://mitadmissions.org/blogs/entry/the_proposal,3252,7,4,9,20
Jul 17 2005,Bryan O. '09,Bertie Botts Every Flavor Beans + Peanuts + Crackerjacks,http://mitadmissions.org/blogs/entry/bertie_botts_every_flavor_bean,3252,0,0,0,0
Jul 17 2005,Jessie L. '07,"I feel the need, the need for speed!",http://mitadmissions.org/blogs/entry/i_feel_the_need_the_need_for_s,3252,0,0,0,0
Jul 17 2005,Sam M. '07,Sweet Transvestite,http://mitadmissions.org/blogs/entry/sweet_transvestite,3252,0,0,0,0
Jul 16 2005,Sam M. '07,"A quick one, while hes away",http://mitadmissions.org/blogs/entry/a_quick_one_while_hes_away,3253,0,0,0,0
Jul 15 2005,Mollie B. '06,How to do everything wrong and still get into MIT,http://mitadmissions.org/blogs/entry/how_to_do_everything_wrong_and,3254,38,23,20,81
Jul 15 2005,Daniel Barkowitz,Calling all Creative Writers,http://mitadmissions.org/blogs/entry/calling_all_creative_writers,3254,0,0,0,0
Jul 15 2005,Jessie L. '07,G(e)e^ks,http://mitadmissions.org/blogs/entry/geeks,3254,0,2,0,2
Jul 15 2005,Matt McGann '00,Boston becomes Pottersville,http://mitadmissions.org/blogs/entry/boston_becomes_pottersville,3254,0,0,0,0
Jul 15 2005,Bryan O. '09,"I-Rop, U-Rop",http://mitadmissions.org/blogs/entry/irop_urop,3254,0,0,0,0
Jul 14 2005,Matt McGann '00,Meet the Admissions Officers: Amy Perez,http://mitadmissions.org/blogs/entry/meet_the_admissions_officers_a_1,3255,0,0,0,0
Jul 14 2005,Sam M. '07,Im a pedestrian! Im a motorist! Pedestrian! Motorist!,http://mitadmissions.org/blogs/entry/im_a_pedestrian_im_a_motorist,3255,0,0,0,0
Jul 13 2005,Mollie B. '06,A flash of brilliance and answers to some questions,http://mitadmissions.org/blogs/entry/a_flash_of_brilliance_and_answ,3256,0,0,0,0
Jul 13 2005,Jessie L. '07,"Beyond the Iron CurI mean, Mass Ave",http://mitadmissions.org/blogs/entry/beyond_the_iron_curi_mean_mass,3256,0,0,0,0
Jul 13 2005,Sam M. '07,"Maine, Episode III: Aint No Mountain",http://mitadmissions.org/blogs/entry/maine_episode_iii_aint_no_moun,3256,0,0,0,0
Jul 13 2005,Matt McGann '00,Mind the Gap,http://mitadmissions.org/blogs/entry/mind_the_gap,3256,0,0,0,0
Jul 13 2005,Daniel Barkowitz,C-Span for Financial Aid Fans,http://mitadmissions.org/blogs/entry/cspan_for_financial_aid_fans,3256,0,0,0,0
Jul 13 2005,Laura N. '09,Work in Progress,http://mitadmissions.org/blogs/entry/work_in_progress,3256,0,0,0,0
Jul 12 2005,Anthony R. '09,"If I Try Really Hard, I Can Resemble Ernest Borgnine",http://mitadmissions.org/blogs/entry/if_i_try_really_hard_i_can_res,3257,0,1,0,1
Jul 12 2005,Daniel Barkowitz,Some Rules to Live By,http://mitadmissions.org/blogs/entry/some_rules_to_live_by,3257,0,0,0,0
Jul 12 2005,Sam M. '07,"Maine, Episode II: Amazing Rain",http://mitadmissions.org/blogs/entry/maine_episode_ii_amazing_rain,3257,0,0,0,0
Jul 12 2005,Matt McGann '00,International Admissions Conference,http://mitadmissions.org/blogs/entry/international_admissions_confe,3257,0,0,0,0
Jul 12 2005,Ben Jones,As The Saying About Assumptions Goes,http://mitadmissions.org/blogs/entry/as_the_saying_about_assumption,3257,0,0,0,0
Jul 12 2005,Bryan O. '09,"Hi, My Name Is: (insert name here)",http://mitadmissions.org/blogs/entry/hi_my_name_is_insert_name_here,3257,0,0,0,0
Jul 11 2005,Mollie B. '06,Hot town,http://mitadmissions.org/blogs/entry/hot_town,3258,0,0,0,0
Jul 11 2005,Daniel Barkowitz,About me About you,http://mitadmissions.org/blogs/entry/about_me_about_you,3258,0,0,0,0
Jul 11 2005,Jessie L. '07,"Yay, weekend!",http://mitadmissions.org/blogs/entry/yay_weekend,3258,0,0,0,0
Jul 11 2005,Mitra L. '07,Le BBQ,http://mitadmissions.org/blogs/entry/le_bbq,3258,0,0,0,0
Jul 10 2005,Sam M. '07,"Maine, Episode I: Hey Joe",http://mitadmissions.org/blogs/entry/maine_episode_i_hey_joe,3259,0,0,0,0
Jul 10 2005,Daniel Barkowitz,Insurance and more blog news,http://mitadmissions.org/blogs/entry/insurance_and_more_blog_news,3259,0,0,0,0
Jul 10 2005,Bryan O. '09,hey hey HAYMARKET,http://mitadmissions.org/blogs/entry/hey_hey_haymarket,3259,0,0,0,0
Jul 10 2005,Matt McGann '00,A New MIT Alum,http://mitadmissions.org/blogs/entry/a_new_mit_alum,3259,0,0,0,0
Jul 8 2005,Matt McGann '00,Meet the Admissions Officers: Matt McGann 00,http://mitadmissions.org/blogs/entry/meet_the_admissions_officers_m,3261,1,1,0,2
Jul 8 2005,Mitra L. '07,Sam Videos,http://mitadmissions.org/blogs/entry/sam_videos,3261,0,0,0,0
Jul 8 2005,Laura N. '09,Flashback,http://mitadmissions.org/blogs/entry/flashback,3261,0,0,0,0
Jul 8 2005,Jessie L. '07,"Bed arrangements in dorms, and beauty on campus",http://mitadmissions.org/blogs/entry/bed_arrangements_in_dorms_and,3261,0,0,0,0
Jul 8 2005,Anthony R. '09,And here I am!,http://mitadmissions.org/blogs/entry/and_here_i_am,3261,0,0,0,0
Jul 7 2005,Mollie B. '06,Application season,http://mitadmissions.org/blogs/entry/application_season,3262,0,0,0,0
Jul 7 2005,Sam M. '07,Pageant and pomp and parade,http://mitadmissions.org/blogs/entry/pageant_and_pomp_and_parade,3262,0,0,0,0
Jul 7 2005,Matt McGann '00,July Questions Omnibus 1,http://mitadmissions.org/blogs/entry/july_questions_omnibus_1,3262,0,0,0,0
Jul 7 2005,Daniel Barkowitz,The (e)bills have hit the (e)mail,http://mitadmissions.org/blogs/entry/the_ebills_have_hit_the_email,3262,0,0,0,0
Jul 7 2005,Jessie L. '07,Painting and a trip into Boston,http://mitadmissions.org/blogs/entry/painting_and_a_trip_into_bosto,3262,0,0,0,0
Jul 7 2005,Laura N. '09,"So who is this Laura person, anyway?",http://mitadmissions.org/blogs/entry/so_who_is_this_laura_person_an,3262,0,0,0,0
Jul 6 2005,Daniel Barkowitz,The Life of a Busy Beaver,http://mitadmissions.org/blogs/entry/the_life_of_a_busy_beaver,3263,0,0,0,0
Jul 6 2005,Mollie B. '06,On abnormality,http://mitadmissions.org/blogs/entry/on_abnormality,3263,0,0,0,0
Jul 6 2005,Mitra L. '07,Nobodys Got No Class!,http://mitadmissions.org/blogs/entry/nobodys_got_no_class,3263,0,0,0,0
Jul 6 2005,Matt McGann '00,Couchamarans and Carboats,http://mitadmissions.org/blogs/entry/couchamarans_and_carboats,3263,0,0,0,0
Jul 6 2005,Ben Jones,What MIT Grads Do With Their Free Time,http://mitadmissions.org/blogs/entry/what_mit_grads_do_with_their_f,3263,0,0,0,0
Jul 6 2005,Bryan O. '09,Making A Splash on July 4: The Celebration in Photos,http://mitadmissions.org/blogs/entry/making_a_splash_on_july_4_the,3263,0,0,0,0
Jul 5 2005,Mollie B. '06,An MIT survival guide,http://mitadmissions.org/blogs/entry/an_mit_survival_guide,3264,1,0,0,1
Jul 5 2005,Mollie B. '06,"You know, that intro stuff",http://mitadmissions.org/blogs/entry/you_know_that_intro_stuff,3264,0,0,0,0
Jul 5 2005,Matt McGann '00,July 4th in Boston,http://mitadmissions.org/blogs/entry/july_4th_in_boston,3264,0,1,4,5
Jul 5 2005,Jessie L. '07,Hello world!,http://mitadmissions.org/blogs/entry/hello_world_1,3264,0,0,0,0
Jul 5 2005,Daniel Barkowitz,If you have your own blog,http://mitadmissions.org/blogs/entry/if_you_have_your_own_blog,3264,0,0,0,0
Jul 5 2005,Sam M. '07,Three of a perfect pair,http://mitadmissions.org/blogs/entry/three_of_a_perfect_pair,3264,0,0,0,0
Jul 5 2005,Bryan O. '09,That is NOT an ice cream flavor.,http://mitadmissions.org/blogs/entry/that_is_not_an_ice_cream_flavo,3264,0,0,0,0
Jul 3 2005,Sam M. '07,See her picture(s) in a thousand places,http://mitadmissions.org/blogs/entry/see_her_pictures_in_a_thousand,3266,0,0,0,0
Jul 2 2005,Mitra L. '07,Help Wanted,http://mitadmissions.org/blogs/entry/help_wanted,3267,0,0,0,0
Jul 2 2005,Sam M. '07,She came in through the bathroom window.,http://mitadmissions.org/blogs/entry/she_came_in_through_the_bathro,3267,0,0,0,0
Jul 1 2005,Bryan O. '09,"Happy 375, Boston!",http://mitadmissions.org/blogs/entry/happy_375_boston,3268,0,0,0,0
Jul 1 2005,Matt McGann '00,Solar Car Pulled Over,http://mitadmissions.org/blogs/entry/solar_car_pulled_over,3268,0,2,0,2
Jun 30 2005,Daniel Barkowitz,"The Bill is Coming, the Bill is coming",http://mitadmissions.org/blogs/entry/the_bill_is_coming_the_bill_is,3269,0,0,0,0
Jun 30 2005,Sam M. '07,Doctor Who?,http://mitadmissions.org/blogs/entry/doctor_who,3269,0,0,0,0
Jun 30 2005,Bryan O. '09,"Summer, Summer, Summertime",http://mitadmissions.org/blogs/entry/summer_summer_summertime,3269,0,0,0,0
Jun 30 2005,Mitra L. '07,Welcome,http://mitadmissions.org/blogs/entry/welcome,3269,0,0,0,0
Jun 30 2005,Bryan O. '09,MIT or Bust,http://mitadmissions.org/blogs/entry/mit_or_bust,3269,0,0,0,0
Jun 29 2005,Daniel Barkowitz,Feeling found,http://mitadmissions.org/blogs/entry/feeling_found,3270,0,0,0,0
Jun 28 2005,Matt McGann '00,Meet the Admissions Officers: Alia Burton 05,http://mitadmissions.org/blogs/entry/meet_the_admissions_officers_a,3271,0,0,0,0
Jun 28 2005,Matt McGann '00,Meet the Admissions Officers,http://mitadmissions.org/blogs/entry/meet_the_admissions_officers,3271,0,0,0,0
Jun 27 2005,Matt McGann '00,Jo-Jo Update,http://mitadmissions.org/blogs/entry/jojo_update,3272,0,0,0,0
Jun 25 2005,Mitra L. '07,MIT References,http://mitadmissions.org/blogs/entry/mit_references,3274,0,0,0,0
Jun 24 2005,Matt McGann '00,Good Luck Jo-Jo!,http://mitadmissions.org/blogs/entry/good_luck_jojo,3275,0,0,0,0
Jun 22 2005,Ben Jones,Back From Paternity Leave,http://mitadmissions.org/blogs/entry/back_from_paternity_leave,3277,0,0,0,0
Jun 22 2005,Bryan O. '09,This is not a smoking gun for superfluidity. This is a cannon.,http://mitadmissions.org/blogs/entry/this_is_not_a_smoking_gun_for,3277,0,0,0,0
Jun 22 2005,Daniel Barkowitz,Self Help Redux and an Update,http://mitadmissions.org/blogs/entry/self_help_redux_and_an_update,3277,0,0,0,0
Jun 22 2005,Sam M. '07,"Hail to the king, baby.",http://mitadmissions.org/blogs/entry/hail_to_the_king_baby,3277,0,0,0,0
Jun 21 2005,Matt McGann '00,Visiting MIT this summer (part 1),http://mitadmissions.org/blogs/entry/visiting_mit_this_summer_part,3278,0,0,0,0
Jun 21 2005,Matt McGann '00,Sidebar: Visiting MIT this summer,http://mitadmissions.org/blogs/entry/sidebar_visiting_mit_this_summ,3278,0,0,0,0
Jun 19 2005,Mitra L. '07,Road Tripsort of.,http://mitadmissions.org/blogs/entry/road_trip_sort_of,3280,0,0,0,0
Jun 18 2005,Sam M. '07,Have you seen your mother baby standing in the shadow?,http://mitadmissions.org/blogs/entry/have_you_seen_your_mother_baby,3281,0,0,0,0
Jun 15 2005,Sam M. '07,One thing every womans missed in Massachusetts Bay,http://mitadmissions.org/blogs/entry/one_thing_every_womans_missed,3284,0,0,0,0
Jun 15 2005,Matt McGann '00,Prof. Acemoglus Clark Medal,http://mitadmissions.org/blogs/entry/prof_acemoglus_clark_medal,3284,0,0,0,0
Jun 15 2005,Anthony R. '09,The summer begins,http://mitadmissions.org/blogs/entry/the_summer_begins,3284,0,0,0,0
Jun 14 2005,Matt McGann '00,"The Scholar, Episode 2",http://mitadmissions.org/blogs/entry/the_scholar_episode_2,3285,0,0,0,0
Jun 14 2005,Daniel Barkowitz,Sometimes you get what you dont pay for,http://mitadmissions.org/blogs/entry/sometimes_you_get_what_you_don,3285,0,0,0,0
Jun 13 2005,Matt McGann '00,June Questions Omnibus 1,http://mitadmissions.org/blogs/entry/june_questions_omnibus_1,3286,0,0,0,0
Jun 11 2005,Mitra L. '07,Go Kendra,http://mitadmissions.org/blogs/entry/go_kendra,3288,0,0,0,0
Jun 10 2005,Matt McGann '00,Summertime,http://mitadmissions.org/blogs/entry/summertime,3289,0,0,0,0
Jun 10 2005,Daniel Barkowitz,Waive and Cosign (or is it Wave and Cosine)?,http://mitadmissions.org/blogs/entry/waive_and_cosign_or_is_it_wave,3289,0,0,0,0
Jun 8 2005,Mitra L. '07,A Visit to eBay,http://mitadmissions.org/blogs/entry/a_visit_to_ebay,3291,0,0,0,0
Jun 8 2005,Mitra L. '07,Why It Pays,http://mitadmissions.org/blogs/entry/why_it_pays,3291,0,0,0,0
Jun 8 2005,Sam M. '07,"Aisumasen, Yoko San",http://mitadmissions.org/blogs/entry/aisumasen_yoko_san,3291,0,0,0,0
Jun 8 2005,Anthony R. '09,"Hello, Im Anthony.",http://mitadmissions.org/blogs/entry/hello_im_anthony,3291,19,3,5,27
Jun 7 2005,Matt McGann '00,The Scholar,http://mitadmissions.org/blogs/entry/the_scholar,3292,0,0,0,0
Jun 6 2005,Matt McGann '00,MIT Commencement,http://mitadmissions.org/blogs/entry/mit_commencement,3293,2,0,0,2
Jun 6 2005,Daniel Barkowitz,"There really are blue skies here (and fine art too!edited June 7, 10:30 Central)",http://mitadmissions.org/blogs/entry/there_really_are_blue_skies_he,3293,0,0,0,0
Jun 4 2005,Daniel Barkowitz,Departing for Bluer Skies,http://mitadmissions.org/blogs/entry/departing_for_bluer_skies,3295,0,0,0,0
Jun 3 2005,Daniel Barkowitz,"Rising Sophomores, Juniors and SeniorsYour Award Letters are in the Mail",http://mitadmissions.org/blogs/entry/rising_sophomores_juniors_and,3296,0,0,0,0
Jun 3 2005,Daniel Barkowitz,Con-GRAD-ulations!,http://mitadmissions.org/blogs/entry/congradulations,3296,0,0,0,0
Jun 2 2005,Matt McGann '00,Spreading the word,http://mitadmissions.org/blogs/entry/spreading_the_word,3297,0,0,0,0
Jun 2 2005,Daniel Barkowitz,Is there Merit in Merit?,http://mitadmissions.org/blogs/entry/is_there_merit_in_merit,3297,0,0,0,0
Jun 1 2005,Ben Jones,"You Guys Are Used To Getting No Sleep, But I Am Old",http://mitadmissions.org/blogs/entry/you_guys_are_used_to_getting_n,3298,0,0,0,0
Jun 1 2005,Daniel Barkowitz,Freshmen housing lottery begins today!,http://mitadmissions.org/blogs/entry/freshmen_housing_lottery_begin,3298,0,0,0,0
Jun 1 2005,Daniel Barkowitz,Preparation for graduation!,http://mitadmissions.org/blogs/entry/preparation_for_graduation,3298,0,0,0,0
May 31 2005,Matt McGann '00,Class of 2009 Numbers,http://mitadmissions.org/blogs/entry/class_of_2009_numbers,3299,0,0,0,0
May 31 2005,Daniel Barkowitz,Its STILL not too late to consolidate (although it almost is) / New loan interest rates for 05-06.,http://mitadmissions.org/blogs/entry/its_still_not_too_late_to_cons,3299,0,0,0,0
May 31 2005,Daniel Barkowitz,All Loans are NOT Created Equal,http://mitadmissions.org/blogs/entry/all_loans_are_not_created_equa,3299,0,0,0,0
May 30 2005,Matt McGann '00,MIT Alum Helps the Red Sox Keith Foulke,http://mitadmissions.org/blogs/entry/mit_alum_helps_the_red_sox_kei,3300,0,0,0,0
May 27 2005,Matt McGann '00,"Soup Dumplings, Fever Pitch",http://mitadmissions.org/blogs/entry/soup_dumplings_fever_pitch,3303,1,0,0,1
May 26 2005,Matt McGann '00,Its The Time To Disco,http://mitadmissions.org/blogs/entry/its_the_time_to_disco,3304,0,0,0,0
May 26 2005,Daniel Barkowitz,Update on the Federal Budget process for Financial Aid,http://mitadmissions.org/blogs/entry/update_on_the_federal_budget_p,3304,0,0,0,0
May 26 2005,Daniel Barkowitz,Another call to action Be a STAR supporter!,http://mitadmissions.org/blogs/entry/another_call_to_action_be_a_st,3304,0,0,0,0
May 25 2005,Matt McGann '00,Comments 3999 & 4000,http://mitadmissions.org/blogs/entry/comments_3999_4000,3305,0,0,0,0
May 24 2005,Matt McGann '00,Nerd movie update,http://mitadmissions.org/blogs/entry/nerd_movie_update,3306,0,0,0,0
May 24 2005,Daniel Barkowitz,"Looking for some advice, you too (U2).",http://mitadmissions.org/blogs/entry/looking_for_some_advice_you_to,3306,0,0,0,0
May 23 2005,Daniel Barkowitz,Reading anything good these days?,http://mitadmissions.org/blogs/entry/reading_anything_good_these_da,3307,0,0,0,0
May 20 2005,Daniel Barkowitz,Want some Advising? Traveling to the Galapagos over lunch.,http://mitadmissions.org/blogs/entry/want_some_advising_traveling_t,3310,0,0,0,0
May 20 2005,Matt McGann '00,Graduations,http://mitadmissions.org/blogs/entry/graduations,3310,0,0,0,0
May 19 2005,Ben Jones,Meet The Admissions Staff,http://mitadmissions.org/blogs/entry/meet_the_admissions_staff,3311,0,0,0,0
May 18 2005,Daniel Barkowitz,Looking for a full scholarship? Want to be on TV?,http://mitadmissions.org/blogs/entry/looking_for_a_full_scholarship,3312,0,0,0,0
May 17 2005,Matt McGann '00,ISEF Wrap-up,http://mitadmissions.org/blogs/entry/isef_wrapup,3313,0,0,0,0
May 17 2005,Daniel Barkowitz,Welcome to the e-bill.,http://mitadmissions.org/blogs/entry/welcome_to_the_ebill,3313,0,0,0,0
May 16 2005,Matt McGann '00,"New York Times, New York Times",http://mitadmissions.org/blogs/entry/new_york_times_new_york_times,3314,0,0,0,0
May 15 2005,Mitra L. '07,Ring Delivery,http://mitadmissions.org/blogs/entry/ring_delivery_1,3315,0,0,0,0
May 13 2005,Daniel Barkowitz,Whose education is it anyway?,http://mitadmissions.org/blogs/entry/whose_education_is_it_anyway,3317,0,0,0,0
May 12 2005,Daniel Barkowitz,And sometimes the changes you make can have great meaning,http://mitadmissions.org/blogs/entry/and_sometimes_the_changes_you,3318,0,0,0,0
May 12 2005,Daniel Barkowitz,Sometimes change is meaningless,http://mitadmissions.org/blogs/entry/sometimes_change_is_meaningles,3318,0,0,0,0
May 12 2005,Matt McGann '00,Cacti and Ice Cream,http://mitadmissions.org/blogs/entry/cacti_and_ice_cream,3318,0,0,0,0
May 11 2005,Matt McGann '00,"5n, n=1",http://mitadmissions.org/blogs/entry/5n_n1,3319,0,0,0,0
May 11 2005,Matt McGann '00,MIT ISEF Lunch,http://mitadmissions.org/blogs/entry/mit_isef_lunch,3319,0,0,0,0
May 10 2005,Matt McGann '00,Waitlist,http://mitadmissions.org/blogs/entry/waitlist,3320,0,0,0,0
May 10 2005,Daniel Barkowitz,Brief update - Award Letters Mailing for International Upperclass Students,http://mitadmissions.org/blogs/entry/brief_update_award_letters_mai,3320,0,0,0,0
May 10 2005,Ben Jones,The Waitlist,http://mitadmissions.org/blogs/entry/the_waitlist,3320,0,0,0,0
May 9 2005,Matt McGann '00,Do You Have A Core Curriculum?,http://mitadmissions.org/blogs/entry/week_in_review,3321,0,1,5,6
May 8 2005,Matt McGann '00,Class of 2009 note #2,http://mitadmissions.org/blogs/entry/class_of_2009_note_2,3322,0,0,0,0
May 7 2005,Daniel Barkowitz,"Respect, Love and Cherish your Mater (Alma and otherwise).",http://mitadmissions.org/blogs/entry/respect_love_and_cherish_your,3323,0,0,0,0
May 6 2005,Ben Jones,Welcome Susan Hockfield,http://mitadmissions.org/blogs/entry/welcome_susan_hockfield,3324,0,0,0,0
May 6 2005,Matt McGann '00,Time Traveling and Teleporting,http://mitadmissions.org/blogs/entry/time_traveling_and_teleporting,3324,0,0,0,0
May 5 2005,Daniel Barkowitz,TOOOOOOOOOO much information,http://mitadmissions.org/blogs/entry/toooooooooo_much_information,3325,0,0,0,0
May 5 2005,Matt McGann '00,Class of 2009 note #1,http://mitadmissions.org/blogs/entry/class_of_2009_note_1,3325,0,0,0,0
May 5 2005,Ben Jones,Happy Cinco De Mayo!!!,http://mitadmissions.org/blogs/entry/happy_cinco_de_mayo,3325,0,0,0,0
May 4 2005,Matt McGann '00,"New York, New York",http://mitadmissions.org/blogs/entry/new_york_new_york,3326,0,0,0,0
May 4 2005,Daniel Barkowitz,The Right Hand DOES know what the Left Hand is Doing,http://mitadmissions.org/blogs/entry/the_right_hand_does_know_what,3326,0,0,0,0
May 4 2005,Ben Jones,Enrolled 09s: Watch Your Mailbox,http://mitadmissions.org/blogs/entry/enrolled_09s_watch_your_mailbo,3326,0,0,0,0
May 3 2005,Ben Jones,Note To Prefrosh With Time Machines and/or Good Ideas,http://mitadmissions.org/blogs/entry/note_to_prefrosh_with_time_mac,3327,0,0,0,0
May 3 2005,Matt McGann '00,College Fair Season,http://mitadmissions.org/blogs/entry/college_fair_season,3327,0,0,0,0
May 3 2005,Daniel Barkowitz,Update on what were up to,http://mitadmissions.org/blogs/entry/update_on_what_were_up_to,3327,0,0,0,0
May 2 2005,Daniel Barkowitz,Calling all time travelers! Come to the first and only time traveler convention!,http://mitadmissions.org/blogs/entry/calling_all_time_travelers_com,3328,0,0,0,0
May 2 2005,Matt McGann '00,Welcome MIT Class of 2009!,http://mitadmissions.org/blogs/entry/welcome_mit_class_of_2009,3328,0,0,0,0
May 1 2005,Matt McGann '00,Time-sensitive matters,http://mitadmissions.org/blogs/entry/timesensitive_matters,3329,0,0,0,0
Apr 29 2005,Matt McGann '00,Two important reminders,http://mitadmissions.org/blogs/entry/two_important_reminders,3331,0,0,0,0
Apr 29 2005,Ben Jones,"And So It Ends, And So It Begins",http://mitadmissions.org/blogs/entry/and_so_it_ends_and_so_it_begin,3331,0,0,0,0
Apr 28 2005,Matt McGann '00,"Decisions, Decisions",http://mitadmissions.org/blogs/entry/decisions_decisions,3332,0,0,0,0
Apr 27 2005,Daniel Barkowitz,Phase Doubt? Look at Interphase,http://mitadmissions.org/blogs/entry/phase_doubt_look_at_interphase,3333,0,0,0,0
Apr 27 2005,Matt McGann '00,5 days to May 2,http://mitadmissions.org/blogs/entry/5_days_to_may_2,3333,0,0,0,0
Apr 26 2005,Daniel Barkowitz,"Who are You?Informal Survey, I need your help",http://mitadmissions.org/blogs/entry/who_are_you_informal_survey_i,3334,0,0,0,0
Apr 26 2005,Matt McGann '00,Post-wedding update,http://mitadmissions.org/blogs/entry/postwedding_update,3334,0,0,0,0
Apr 24 2005,Daniel Barkowitz,"Hey, Graduating College Seniors (and Graduating Graduate Students): Its Not Too Late to Consolidate",http://mitadmissions.org/blogs/entry/hey_graduating_college_seniors,3336,0,0,0,0
Apr 22 2005,Daniel Barkowitz,Clearing the Decks (or the Desk)The Return of the Return of More Questions Answered.,http://mitadmissions.org/blogs/entry/clearing_the_decks_or_the_desk,3338,0,0,0,0
Apr 22 2005,Matt McGann '00,Bruno Recalibration,http://mitadmissions.org/blogs/entry/bruno_recalibration,3338,0,4,0,4
Apr 20 2005,Matt McGann '00,April Questions Omnibus 2,http://mitadmissions.org/blogs/entry/april_questions_omnibus_2,3340,0,0,0,0
Apr 15 2005,Matt McGann '00,Multi-Day Weekend at MIT,http://mitadmissions.org/blogs/entry/multiday_weekend_at_mit,3345,0,0,0,0
Apr 14 2005,Matt McGann '00,The Cambridge-MIT Exchange,http://mitadmissions.org/blogs/entry/the_cambridgemit_exchange,3346,1,0,0,1
Apr 12 2005,Matt McGann '00,More CPW Pix,http://mitadmissions.org/blogs/entry/more_cpw_pix,3348,0,0,0,0
Apr 11 2005,Daniel Barkowitz,Call for CPW Pics,http://mitadmissions.org/blogs/entry/call_for_cpw_pics,3349,0,0,0,0
Apr 11 2005,Matt McGann '00,CPW Feedback,http://mitadmissions.org/blogs/entry/cpw_feedback,3349,0,0,0,0
Apr 11 2005,Matt McGann '00,CPW Saturday,http://mitadmissions.org/blogs/entry/cpw_saturday,3349,0,0,0,0
Apr 9 2005,Ben Jones,CPW Day 3,http://mitadmissions.org/blogs/entry/cpw_day_3,3351,0,0,0,0
Apr 9 2005,Ben Jones,CPW Day 3,http://mitadmissions.org/blogs/entry/cpw_day_31,3351,0,0,0,0
Apr 8 2005,Ben Jones,CPW Day 2,http://mitadmissions.org/blogs/entry/cpw_day_2,3352,0,0,0,0
Apr 8 2005,Ben Jones,CPW Day 2,http://mitadmissions.org/blogs/entry/cpw_day_21,3352,0,0,0,0
Apr 8 2005,Matt McGann '00,CPW Festival,http://mitadmissions.org/blogs/entry/cpw_festival,3352,0,0,0,0
Apr 7 2005,Ben Jones,CPW Day 1,http://mitadmissions.org/blogs/entry/cpw_day_1,3353,0,0,0,0
Apr 5 2005,Daniel Barkowitz,Presenting my CPW Presentation,http://mitadmissions.org/blogs/entry/presenting_my_cpw_presentation,3355,0,0,0,0
Apr 4 2005,Matt McGann '00,April Questions Omnibus 1,http://mitadmissions.org/blogs/entry/april_questions_omnibus_1,3356,0,0,0,0
Apr 4 2005,Ben Jones,Blog Links,http://mitadmissions.org/blogs/entry/blog_links,3356,0,0,0,0
Apr 3 2005,Matt McGann '00,CPW Hosts,http://mitadmissions.org/blogs/entry/cpw_hosts,3357,0,0,0,0
Apr 2 2005,Matt McGann '00,Majors,http://mitadmissions.org/blogs/entry/majors,3358,0,0,0,0
Mar 31 2005,Daniel Barkowitz,When it feels like another logic puzzle How to afford your EFC?,http://mitadmissions.org/blogs/entry/when_it_feels_like_another_log,3360,0,0,0,0
Mar 30 2005,Matt McGann '00,A Beautiful Day,http://mitadmissions.org/blogs/entry/a_beautiful_day,3361,0,0,0,0
Mar 30 2005,Matt McGann '00,Admitted Students Parties Followup,http://mitadmissions.org/blogs/entry/admitted_students_parties_foll,3361,0,0,0,0
Mar 29 2005,Daniel Barkowitz,More News IS Good News And a Logic Problem to boot (updated 03/30/05 - 5:00 PM),http://mitadmissions.org/blogs/entry/more_news_is_good_news_and_a_l,3362,0,0,0,0
Mar 28 2005,Matt McGann '00,Admitted Students Parties,http://mitadmissions.org/blogs/entry/admitted_students_parties,3363,0,0,0,0
Mar 28 2005,Daniel Barkowitz,Satisfying Your Self Help Supplications (you try finding an S word that means questions).,http://mitadmissions.org/blogs/entry/satisfying_your_self_help_supp,3363,0,0,0,0
Mar 28 2005,Matt McGann '00,Exciting potential UROP: the cancer genome,http://mitadmissions.org/blogs/entry/exciting_potential_urop_the_ca,3363,0,0,0,0
Mar 28 2005,Ben Jones,In Real Life,http://mitadmissions.org/blogs/entry/in_real_life,3363,0,0,0,0
Mar 25 2005,Daniel Barkowitz,C U @ CPW,http://mitadmissions.org/blogs/entry/c_u_cpw,3366,0,0,0,0
Mar 25 2005,Matt McGann '00,March Questions Omnibus 4,http://mitadmissions.org/blogs/entry/march_questions_omnibus_4,3366,0,0,0,0
Mar 24 2005,Daniel Barkowitz,When Your Dream Still Seems Out of Reach,http://mitadmissions.org/blogs/entry/when_your_dream_still_seems_ou,3367,0,0,0,0
Mar 23 2005,Matt McGann '00,Spring Weekend Concert Announced: Fabolous and Lloyd Banks,http://mitadmissions.org/blogs/entry/spring_weekend_concert_announc,3368,0,0,0,0
Mar 23 2005,Daniel Barkowitz,More awards in the mail. More to come on Thursday.,http://mitadmissions.org/blogs/entry/more_awards_in_the_mail_more_t,3368,0,0,0,0
Mar 22 2005,Matt McGann '00,Varsity Pistol Team Wins National Championship,http://mitadmissions.org/blogs/entry/varsity_pistol_team_wins_natio,3369,0,0,0,0
Mar 21 2005,Matt McGann '00,MIT wins Putnam math competition,http://mitadmissions.org/blogs/entry/mit_wins_putnam_math_competiti,3370,1,0,0,1
Mar 21 2005,Ben Jones,Bad Haiku,http://mitadmissions.org/blogs/entry/bad_haiku,3370,0,0,0,0
Mar 20 2005,Matt McGann '00,March Questions Omnibus 3,http://mitadmissions.org/blogs/entry/march_questions_omnibus_3,3371,0,0,0,0
Mar 20 2005,Daniel Barkowitz,Congratulations - We Made the Boston Globe,http://mitadmissions.org/blogs/entry/congratulations_we_made_the_bo,3371,0,0,0,0
Mar 19 2005,Daniel Barkowitz,How We Determined Your Award,http://mitadmissions.org/blogs/entry/how_we_determined_your_award,3372,0,0,0,0
Mar 19 2005,Daniel Barkowitz,My quote for inspiration.,http://mitadmissions.org/blogs/entry/my_quote_for_inspiration,3372,0,0,0,0
Mar 18 2005,Daniel Barkowitz,The Letters are Out the Door,http://mitadmissions.org/blogs/entry/the_letters_are_out_the_door_1,3373,0,0,0,0
Mar 18 2005,Matt McGann '00,"New stuff on MyMIT, and more",http://mitadmissions.org/blogs/entry/new_stuff_on_mymit_and_more,3373,0,0,0,0
Mar 18 2005,Ben Jones,"Online Decisions, Sortof",http://mitadmissions.org/blogs/entry/online_decisions_sortof,3373,0,0,0,0
Mar 17 2005,Daniel Barkowitz,"The Letters are Coming, the Letters are Coming",http://mitadmissions.org/blogs/entry/the_letters_are_coming_the_let,3374,0,0,0,0
Mar 17 2005,Ben Jones,The Burning Question Part 2,http://mitadmissions.org/blogs/entry/the_burning_question_part_2,3374,0,0,0,0
Mar 16 2005,Ben Jones,The Burning Question,http://mitadmissions.org/blogs/entry/the_burning_question,3375,0,0,0,0
Mar 16 2005,Ben Jones,Upside-Down Letters,http://mitadmissions.org/blogs/entry/upsidedown_letters,3375,0,0,0,0
Mar 15 2005,Daniel Barkowitz,The IDOCs of March,http://mitadmissions.org/blogs/entry/the_idocs_of_march,3376,0,0,0,0
Mar 15 2005,Ben Jones,Waitlist Questions,http://mitadmissions.org/blogs/entry/waitlist_questions,3376,0,0,0,0
Mar 15 2005,Ben Jones,Two Sides Of The Coin For Us Too,http://mitadmissions.org/blogs/entry/two_sides_of_the_coin_for_us_t,3376,0,0,0,0
Mar 14 2005,Ben Jones,Please Stop,http://mitadmissions.org/blogs/entry/please_stop,3377,0,0,0,0
Mar 14 2005,Ben Jones,Decisions Are Beginning To Arrive,http://mitadmissions.org/blogs/entry/decisions_are_beginning_to_arr,3377,0,0,0,0
Mar 14 2005,Ben Jones,Changes To Your MyMIT Account,http://mitadmissions.org/blogs/entry/changes_to_your_mymit_account,3377,0,0,0,0
Mar 14 2005,Matt McGann '00,The Ides of March,http://mitadmissions.org/blogs/entry/the_ides_of_march,3377,0,0,0,0
Mar 14 2005,Matt McGann '00, Day,http://mitadmissions.org/blogs/entry/day,3377,0,0,0,0
Mar 14 2005,Ben Jones,The DHL Fiasco,http://mitadmissions.org/blogs/entry/the_dhl_fiasco,3377,0,0,0,0
Mar 14 2005,Daniel Barkowitz, Day (and Latkes and Hamentashen),http://mitadmissions.org/blogs/entry/day_and_latkes_and_hamentashe,3377,0,0,0,0
Mar 13 2005,Matt McGann '00,MIT homepage,http://mitadmissions.org/blogs/entry/mit_homepage,3378,0,0,0,0
Mar 13 2005,Matt McGann '00,The Ethicist,http://mitadmissions.org/blogs/entry/the_ethicist,3378,0,0,0,0
Mar 12 2005,Daniel Barkowitz,Once you have your letter,http://mitadmissions.org/blogs/entry/once_you_have_your_letter,3379,0,0,0,0
Mar 11 2005,Daniel Barkowitz,And theyre off,http://mitadmissions.org/blogs/entry/and_theyre_off,3380,0,0,0,0
Mar 11 2005,Matt McGann '00,Decisions mailed;,http://mitadmissions.org/blogs/entry/decisions_mailed_15_admitted,3380,0,0,0,0
Mar 11 2005,Ben Jones,In The Mail,http://mitadmissions.org/blogs/entry/in_the_mail,3380,0,0,0,0
Mar 11 2005,Ben Jones,Todays Mailing Day,http://mitadmissions.org/blogs/entry/todays_mailing_day,3380,0,0,0,0
Mar 11 2005,Matt McGann '00,March Questions Omnibus 2,http://mitadmissions.org/blogs/entry/march_questions_omnibus_2,3380,0,0,0,0
Mar 10 2005,Daniel Barkowitz,The Best Laid Plans,http://mitadmissions.org/blogs/entry/the_best_laid_plans,3381,0,0,0,0
Mar 9 2005,Matt McGann '00,Windy city,http://mitadmissions.org/blogs/entry/windy_city,3382,0,0,0,0
Mar 8 2005,Matt McGann '00,"MITE2S, RSI, and more",http://mitadmissions.org/blogs/entry/mite2s_rsi_and_more,3383,0,0,0,0
Mar 8 2005,Daniel Barkowitz,URGENT! We Need Your Help Help Save the Federal Perkins Program.,http://mitadmissions.org/blogs/entry/urgent_we_need_your_help_help,3383,0,0,0,0
Mar 8 2005,Daniel Barkowitz,"Decisions Mailed, Tuition Announced, The Return of More Questions Answered, and Opening and Closing ",http://mitadmissions.org/blogs/entry/decisions_mailed_tuition_annou,3383,0,0,0,0
Mar 8 2005,Ben Jones,Only You Have The Power,http://mitadmissions.org/blogs/entry/only_you_have_the_power,3383,0,1,0,1
Mar 8 2005,Ben Jones,"Status Pic, As Promised",http://mitadmissions.org/blogs/entry/status_pic_as_promised,3383,0,0,0,0
Mar 8 2005,Ben Jones,Back From The West Coast,http://mitadmissions.org/blogs/entry/back_from_the_west_coast,3383,0,0,0,0
Mar 7 2005,Matt McGann '00,International Selection Day 2,http://mitadmissions.org/blogs/entry/international_selection_day_2,3384,0,0,0,0
Mar 6 2005,Matt McGann '00,International Selection Day 1,http://mitadmissions.org/blogs/entry/international_selection_day_1,3385,0,0,0,0
Mar 6 2005,Matt McGann '00,Planned Mail Date: March 11,http://mitadmissions.org/blogs/entry/planned_mail_date_march_11,3385,0,0,0,0
Mar 5 2005,Ben Jones,Decision Mail Date: March 11,http://mitadmissions.org/blogs/entry/decision_mail_date_march_11,3386,0,0,0,0
Mar 5 2005,Matt McGann '00,March Questions Omnibus 1,http://mitadmissions.org/blogs/entry/march_questions_omnibus_1,3386,0,0,0,0
Mar 3 2005,Daniel Barkowitz,Verification Rap,http://mitadmissions.org/blogs/entry/verification_rap_1,3388,2,1,0,3
Mar 3 2005,Daniel Barkowitz,One clarification to student contribution,http://mitadmissions.org/blogs/entry/one_clarification_to_student_c,3388,0,0,0,0
Mar 3 2005,Daniel Barkowitz,In honor of those of you waiting to hear,http://mitadmissions.org/blogs/entry/in_honor_of_those_of_you_waiti,3388,0,0,0,0
Mar 2 2005,Daniel Barkowitz,The rest of the bunch Parts 3 and 4 of your family contribution,http://mitadmissions.org/blogs/entry/the_rest_of_the_bunch_parts_3,3389,0,0,0,0
Mar 2 2005,Daniel Barkowitz,Solutions,http://mitadmissions.org/blogs/entry/solutions,3389,0,0,0,0
Mar 2 2005,Matt McGann '00,Radio Radio,http://mitadmissions.org/blogs/entry/radio_radio,3389,0,0,0,0
Mar 1 2005,Matt McGann '00,Trading Room,http://mitadmissions.org/blogs/entry/trading_room,3390,0,0,0,0
Mar 1 2005,Matt McGann '00,Quick update,http://mitadmissions.org/blogs/entry/quick_update,3390,0,0,0,0
Feb 28 2005,Matt McGann '00,The Brass Rat,http://mitadmissions.org/blogs/entry/the_brass_rat,3391,0,1,0,1
Feb 26 2005,Matt McGann '00,RA Selection Day 8 & Beyond,http://mitadmissions.org/blogs/entry/ra_selection_day_8_beyond,3393,0,0,0,0
Feb 26 2005,Daniel Barkowitz,Its all fun and games to me,http://mitadmissions.org/blogs/entry/its_all_fun_and_games_to_me,3393,0,0,0,0
Feb 25 2005,Daniel Barkowitz,Were not Big Brother (were more like a friendly cousin).,http://mitadmissions.org/blogs/entry/were_not_big_brother_were_more,3394,0,0,0,0
Feb 24 2005,Ben Jones,"Very, Very Important News",http://mitadmissions.org/blogs/entry/very_very_important_news,3395,0,0,0,0
Feb 24 2005,Daniel Barkowitz,Some more pictures,http://mitadmissions.org/blogs/entry/some_more_pictures,3395,0,0,0,0
Feb 24 2005,Daniel Barkowitz,Mitras Blog and an interesting question,http://mitadmissions.org/blogs/entry/mitras_blog_and_an_interesting,3395,0,0,0,0
Feb 24 2005,Matt McGann '00,RA Selection Day 7,http://mitadmissions.org/blogs/entry/ra_selection_day_7,3395,0,0,0,0
Feb 23 2005,Daniel Barkowitz,Who Are You? (who who who who) I really want to know. Who Are You?,http://mitadmissions.org/blogs/entry/who_are_you_who_who_who_who_i,3396,0,0,0,0
Feb 22 2005,Matt McGann '00,RA Selection Day 6,http://mitadmissions.org/blogs/entry/ra_selection_day_6,3397,0,0,0,0
Feb 22 2005,Matt McGann '00,Selection-time Questions Omnibus,http://mitadmissions.org/blogs/entry/selectiontime_questions_omnibu,3397,0,0,0,0
Feb 22 2005,Daniel Barkowitz,"Reading, Reading and more Reading",http://mitadmissions.org/blogs/entry/reading_reading_and_more_readi,3397,0,0,0,0
Feb 21 2005,Matt McGann '00,RA Selection Day 5 and a day off (kinda),http://mitadmissions.org/blogs/entry/ra_selection_day_5_and_a_day_o,3398,0,0,0,0
Feb 21 2005,Ben Jones,Notes From The Middle Of Selection,http://mitadmissions.org/blogs/entry/notes_from_the_middle_of_selec,3398,0,0,0,0
Feb 19 2005,Matt McGann '00,RA Selection Day 4,http://mitadmissions.org/blogs/entry/ra_selection_day_4,3400,0,0,0,0
Feb 19 2005,Matt McGann '00,RA Selection Day 3,http://mitadmissions.org/blogs/entry/ra_selection_day_3,3400,0,0,0,0
Feb 17 2005,Matt McGann '00,FAQ,http://mitadmissions.org/blogs/entry/faq,3402,0,0,0,0
Feb 17 2005,Matt McGann '00,RA Selection Day 2,http://mitadmissions.org/blogs/entry/ra_selection_day_2,3402,0,0,0,0
Feb 16 2005,Matt McGann '00,"Selecting from 10,439 applications and a dozen ties.",http://mitadmissions.org/blogs/entry/selecting_from_10439_applicati,3403,0,0,0,0
Feb 15 2005,Matt McGann '00,This weeks Questions Omnibus,http://mitadmissions.org/blogs/entry/this_weeks_questions_omnibus,3404,0,0,0,0
Feb 15 2005,Ben Jones,The Day Before Selection Begins,http://mitadmissions.org/blogs/entry/the_day_before_selection_begin,3404,0,0,0,0
Feb 15 2005,Matt McGann '00,Science Times,http://mitadmissions.org/blogs/entry/science_times,3404,0,0,0,0
Feb 14 2005,Matt McGann '00,Happy V-Day,http://mitadmissions.org/blogs/entry/happy_vday,3405,0,0,0,0
Feb 13 2005,Matt McGann '00,Everybodys Reading Applications!,http://mitadmissions.org/blogs/entry/everybodys_reading_application,3406,0,0,0,0
Feb 10 2005,Matt McGann '00,Annas Taqueria,http://mitadmissions.org/blogs/entry/annas_taqueria,3409,0,0,0,0
Feb 10 2005,Daniel Barkowitz,"For Upperclass (Sophomore, Junior, Senior) Students and Transfers",http://mitadmissions.org/blogs/entry/for_upperclass_sophomore_junio,3409,0,0,0,0
Feb 8 2005,Matt McGann '00,Dont believe everything that you read,http://mitadmissions.org/blogs/entry/dont_believe_everything_that_y,3411,0,0,0,0
Feb 8 2005,Daniel Barkowitz,Another article worth reading,http://mitadmissions.org/blogs/entry/another_article_worth_reading,3411,0,0,0,0
Feb 8 2005,Daniel Barkowitz,Its February 8th Do you know where your FAFSA is?,http://mitadmissions.org/blogs/entry/its_february_8th_do_you_know_w,3411,0,0,0,0
Feb 7 2005,Matt McGann '00,"Questions Omnibus, Part 1",http://mitadmissions.org/blogs/entry/questions_omnibus_part_1,3412,0,0,0,0
Feb 7 2005,Matt McGann '00,"Questions Omnibus, Part 2",http://mitadmissions.org/blogs/entry/questions_omnibus_part_2,3412,0,0,0,0
Feb 5 2005,Matt McGann '00,XREG,http://mitadmissions.org/blogs/entry/xreg,3414,0,0,0,0
Feb 3 2005,Matt McGann '00,Busy times,http://mitadmissions.org/blogs/entry/busy_times,3416,0,0,0,0
Feb 3 2005,Ben Jones,New MIT Viewbook,http://mitadmissions.org/blogs/entry/new_mit_viewbook,3416,0,0,0,0
Feb 2 2005,Daniel Barkowitz,Random 10 Songs on iTunes - the game,http://mitadmissions.org/blogs/entry/random_10_songs_on_itunes_the,3417,0,0,0,0
Feb 1 2005,Matt McGann '00,Scholarships,http://mitadmissions.org/blogs/entry/scholarships,3418,0,0,0,0
Feb 1 2005,Daniel Barkowitz,Part 2: Parental Contribution from Assets,http://mitadmissions.org/blogs/entry/part_2_parental_contribution_f,3418,0,0,0,0
Feb 1 2005,Ben Jones,Stu Saves The Pact,http://mitadmissions.org/blogs/entry/stu_saves_the_pact,3418,0,0,0,0
Jan 31 2005,Matt McGann '00,More questions,http://mitadmissions.org/blogs/entry/more_questions,3419,0,0,0,0
Jan 31 2005,Mitra L. '07,"Charmed, Im Sure",http://mitadmissions.org/blogs/entry/charmed_im_sure,3419,0,0,0,0
Jan 31 2005,Ben Jones,And Then There Was One,http://mitadmissions.org/blogs/entry/and_then_there_was_one,3419,0,0,0,0
Jan 29 2005,Matt McGann '00,A Day in the Life (of IAP),http://mitadmissions.org/blogs/entry/a_day_in_the_life_of_iap,3421,0,0,0,0
Jan 29 2005,Daniel Barkowitz,Early Admits? Theres a letter in the mail to you And some more of your questions answered.,http://mitadmissions.org/blogs/entry/early_admits_theres_a_letter_i,3421,0,0,0,0
Jan 28 2005,Matt McGann '00,Our friends,http://mitadmissions.org/blogs/entry/our_friends,3422,0,1,0,1
Jan 28 2005,Ben Jones,"The Beard, The Name, The Response, and EC",http://mitadmissions.org/blogs/entry/the_beard_the_name_the_respons,3422,0,0,0,0
Jan 27 2005,Matt McGann '00,Match Game,http://mitadmissions.org/blogs/entry/match_game,3423,0,0,0,0
Jan 27 2005,Ben Jones,Welcome To Room 3-107,http://mitadmissions.org/blogs/entry/welcome_to_room_3107,3423,0,0,0,0
Jan 26 2005,Daniel Barkowitz,Seeing double? Time for a visit with the IDOC.,http://mitadmissions.org/blogs/entry/seeing_double_time_for_a_visit,3424,0,0,0,0
Jan 25 2005,Daniel Barkowitz,Interesting article from CNN on the 4 myths,http://mitadmissions.org/blogs/entry/interesting_article_from_cnn_o,3425,0,0,0,0
Jan 23 2005,Matt McGann '00,On schools & context,http://mitadmissions.org/blogs/entry/on_schools_context,3427,1,0,0,1
Jan 22 2005,Matt McGann '00,A Nibble of Music,http://mitadmissions.org/blogs/entry/a_nibble_of_music,3428,0,0,0,0
Jan 20 2005,Matt McGann '00,Writers Bloc,http://mitadmissions.org/blogs/entry/writers_bloc,3430,0,0,0,0
Jan 20 2005,Daniel Barkowitz,Determining the parent contribution from income,http://mitadmissions.org/blogs/entry/determining_the_parent_contrib,3430,0,0,0,0
Jan 19 2005,Matt McGann '00,Likelihood,http://mitadmissions.org/blogs/entry/likelihood,3431,0,3,0,3
Jan 18 2005,Matt McGann '00,Normalville,http://mitadmissions.org/blogs/entry/normalville,3432,0,0,0,0
Jan 16 2005,Daniel Barkowitz,Random 10 Songs on iTunes,http://mitadmissions.org/blogs/entry/random_10_songs_on_itunes,3434,0,0,0,0
Jan 15 2005,Matt McGann '00,Mystery Hunt in progress,http://mitadmissions.org/blogs/entry/mystery_hunt_in_progress,3435,0,0,0,0
Jan 14 2005,Ben Jones,Highlights From The Past Week,http://mitadmissions.org/blogs/entry/highlights_from_the_past_week,3436,0,0,0,0
Jan 13 2005,Matt McGann '00,The ratio of people to cake is too big.,http://mitadmissions.org/blogs/entry/the_ratio_of_people_to_cake_is,3437,0,0,0,0
Jan 12 2005,Daniel Barkowitz,Singing in Four Part HarmonyOr What Makes up your EFC.,http://mitadmissions.org/blogs/entry/singing_in_four_part_harmony_o,3438,0,0,0,0
Jan 12 2005,Matt McGann '00,Monkey Dance,http://mitadmissions.org/blogs/entry/monkey_dance,3438,0,0,0,0
Jan 11 2005,Daniel Barkowitz,And even more answers (plus some IAP info)!,http://mitadmissions.org/blogs/entry/and_even_more_answers_plus_som,3439,0,0,0,0
Jan 9 2005,Matt McGann '00,5 days until Mystery Hunt,http://mitadmissions.org/blogs/entry/5_days_until_mystery_hunt,3441,0,0,0,0
Jan 8 2005,Matt McGann '00,International Men & Women of Mystery,http://mitadmissions.org/blogs/entry/international_men_women_of_mys,3442,3,2,0,5
Jan 7 2005,Matt McGann '00,A ditch on the side of the New Jersey Turnpike,http://mitadmissions.org/blogs/entry/a_ditch_on_the_side_of_the_new,3443,0,0,0,0
Jan 7 2005,Ben Jones,"A New Years Resolution, MyMIT-Style",http://mitadmissions.org/blogs/entry/a_new_years_resolution_mymitst,3443,0,0,0,0
Jan 6 2005,Matt McGann '00,Jargon,http://mitadmissions.org/blogs/entry/jargon,3444,2,1,0,3
Jan 6 2005,Matt McGann '00,The blogs are back in town,http://mitadmissions.org/blogs/entry/the_blogs_are_back_in_town,3444,0,0,0,0
Jan 4 2005,Matt McGann '00,"The mail, and more",http://mitadmissions.org/blogs/entry/the_mail_and_more,3446,0,0,0,0
Jan 4 2005,Daniel Barkowitz,Some more answers to your questions,http://mitadmissions.org/blogs/entry/some_more_answers_to_your_ques,3446,0,0,0,0
Dec 31 2004,Matt McGann '00,(Q & A)^(n+1),http://mitadmissions.org/blogs/entry/q_an1,3450,0,0,0,0
Dec 29 2004,Daniel Barkowitz,Is your PIN broken? How do you fix it?,http://mitadmissions.org/blogs/entry/is_your_pin_broken_how_do_you,3452,0,0,0,0
Dec 29 2004,Matt McGann '00,Application season,http://mitadmissions.org/blogs/entry/application_season_1,3452,0,0,0,0
Dec 28 2004,Daniel Barkowitz,PROFILE questions?,http://mitadmissions.org/blogs/entry/profile_questions,3453,0,0,0,0
Dec 28 2004,Daniel Barkowitz,FAFSA Questions?,http://mitadmissions.org/blogs/entry/fafsa_questions,3453,0,0,0,0
Dec 28 2004,Daniel Barkowitz,"Do you want the 10,000 foot view? Or the extreme closeup?",http://mitadmissions.org/blogs/entry/do_you_want_the_10000_foot_vie,3453,0,0,0,0
Dec 27 2004,Matt McGann '00,How about an e Reunion?,http://mitadmissions.org/blogs/entry/how_about_an_e_reunion,3454,0,0,0,0
Dec 27 2004,Daniel Barkowitz,Take a look at the MIT home page,http://mitadmissions.org/blogs/entry/take_a_look_at_the_mit_home_pa,3454,0,0,0,0
Dec 25 2004,Daniel Barkowitz,T minus 8 and counting,http://mitadmissions.org/blogs/entry/t_minus_8_and_counting,3456,0,0,0,0
Dec 24 2004,Matt McGann '00,Christmas with the McGanns,http://mitadmissions.org/blogs/entry/christmas_with_the_mcganns,3457,0,0,0,0
Dec 22 2004,Daniel Barkowitz,Happy Gary Homas Birthday!,http://mitadmissions.org/blogs/entry/happy_gary_homas_birthday,3459,0,0,0,0
Dec 21 2004,Matt McGann '00,Christmas in December and July,http://mitadmissions.org/blogs/entry/christmas_in_december_and_july,3460,0,0,0,0
Dec 21 2004,Daniel Barkowitz,While visions of algorithms dance in their heads,http://mitadmissions.org/blogs/entry/while_visions_of_algorithms_da,3460,0,0,0,0
Dec 20 2004,Ben Jones,Long-Overdue Responses,http://mitadmissions.org/blogs/entry/longoverdue_responses,3461,0,0,0,0
Dec 20 2004,Daniel Barkowitz,Rest for the weary,http://mitadmissions.org/blogs/entry/rest_for_the_weary,3461,0,0,0,0
Dec 18 2004,Matt McGann '00,"We, the people",http://mitadmissions.org/blogs/entry/we_the_people,3463,0,0,0,0
Dec 18 2004,Ben Jones,Clarification On Last Post,http://mitadmissions.org/blogs/entry/clarification_on_last_post,3463,0,0,0,0
Dec 17 2004,Matt McGann '00,End of term,http://mitadmissions.org/blogs/entry/end_of_term,3464,0,0,0,0
Dec 17 2004,Matt McGann '00,IM sports totally rock,http://mitadmissions.org/blogs/entry/im_sports_totally_rock,3464,0,0,0,0
Dec 17 2004,Matt McGann '00,The Biological Engineering major,http://mitadmissions.org/blogs/entry/the_biological_engineering_maj,3464,0,0,0,0
Dec 16 2004,Ben Jones,There Is No Formula,http://mitadmissions.org/blogs/entry/there_is_no_formula,3465,17,13,3,33
Dec 16 2004,Matt McGann '00,Stress,http://mitadmissions.org/blogs/entry/stress,3465,0,0,0,0
Dec 15 2004,Matt McGann '00,More on deferrals,http://mitadmissions.org/blogs/entry/more_on_deferrals,3466,0,0,0,0
Dec 13 2004,Matt McGann '00,The waiting is the hardest part,http://mitadmissions.org/blogs/entry/the_waiting_is_the_hardest_par,3468,1,0,0,1
Dec 12 2004,Matt McGann '00,Everyday Is Like Sunday,http://mitadmissions.org/blogs/entry/everyday_is_like_sunday,3469,0,0,0,0
Dec 11 2004,Ben Jones,Late Night Thoughts On You Guys & This Whole Process,http://mitadmissions.org/blogs/entry/late_night_thoughts_on_you_guy,3470,0,0,0,0
Dec 10 2004,Daniel Barkowitz,Answering some questions Commenting on comments Questioning some answers,http://mitadmissions.org/blogs/entry/answering_some_questions_comme,3471,0,0,0,0
Dec 10 2004,Ben Jones,EA Letters Are In The Mail,http://mitadmissions.org/blogs/entry/ea_letters_are_in_the_mail,3471,0,0,0,0
Dec 10 2004,Matt McGann '00,Decision letters mailed,http://mitadmissions.org/blogs/entry/decision_letters_mailed,3471,0,0,0,0
Dec 10 2004,Daniel Barkowitz,Its not apparent who is a parent,http://mitadmissions.org/blogs/entry/its_not_apparent_who_is_a_pare_1,3471,0,0,0,0
Dec 10 2004,Matt McGann '00,Odds & ends,http://mitadmissions.org/blogs/entry/odds_ends,3471,0,0,0,0
Dec 9 2004,Matt McGann '00,"Summer days, driftin away",http://mitadmissions.org/blogs/entry/summer_days_driftin_away,3472,0,1,0,1
Dec 8 2004,Matt McGann '00,Share the joy,http://mitadmissions.org/blogs/entry/share_the_joy,3473,0,0,0,0
Dec 7 2004,Daniel Barkowitz,"Tell me where have you been, Danny-Boy, Danny-Boy",http://mitadmissions.org/blogs/entry/tell_me_where_have_you_been_da,3474,0,0,0,0
Dec 6 2004,Matt McGann '00,Selection Day 3,http://mitadmissions.org/blogs/entry/selection_day_3,3475,0,0,0,0
Dec 4 2004,Matt McGann '00,Selection Day 2,http://mitadmissions.org/blogs/entry/selection_day_2,3477,1,0,0,1
Dec 3 2004,Matt McGann '00,Selection,http://mitadmissions.org/blogs/entry/selection_1,3478,0,0,0,0
Dec 1 2004,Matt McGann '00,President Susan Hockfield,http://mitadmissions.org/blogs/entry/president_susan_hockfield,3480,0,0,0,0
Nov 30 2004,Matt McGann '00,And then Trogdor smote the Kerrek,http://mitadmissions.org/blogs/entry/and_then_trogdor_smote_the_ker,3481,0,0,0,0
Nov 29 2004,Matt McGann '00,Trp,http://mitadmissions.org/blogs/entry/trp,3482,0,0,0,0
Nov 23 2004,Matt McGann '00,"2,822 applications",http://mitadmissions.org/blogs/entry/2822_applications,3488,0,0,0,0
Nov 21 2004,Matt McGann '00,Some people call me the space cowgirl,http://mitadmissions.org/blogs/entry/some_people_call_me_the_space,3490,0,0,0,0
Nov 20 2004,Matt McGann '00,Whats the big deal about 40^2?,http://mitadmissions.org/blogs/entry/whats_the_big_deal_about_402,3491,111,50,72,233
Nov 18 2004,Daniel Barkowitz,Looking forward to Monday,http://mitadmissions.org/blogs/entry/looking_forward_to_monday,3493,0,0,0,0
Nov 17 2004,Matt McGann '00,P(Happy Chanukah),http://mitadmissions.org/blogs/entry/phappy_chanukah,3494,0,0,0,0
Nov 17 2004,Matt McGann '00,Speaking of mu,http://mitadmissions.org/blogs/entry/speaking_of_mu,3494,0,0,0,0
Nov 16 2004,Matt McGann '00,Did the quadratic formula explode?,http://mitadmissions.org/blogs/entry/did_the_quadratic_formula_expl,3495,0,0,0,0
Nov 15 2004,Daniel Barkowitz,Armchair traveling,http://mitadmissions.org/blogs/entry/armchair_traveling_old,3496,0,0,0,0
Nov 14 2004,Matt McGann '00,Application dreaming,http://mitadmissions.org/blogs/entry/application_dreaming,3497,0,0,0,0
Nov 14 2004,Ben Jones,App Reading In The Western Burbs,http://mitadmissions.org/blogs/entry/app_reading_in_the_western_bur,3497,0,0,0,0
Nov 12 2004,Daniel Barkowitz,The History and Mystery of / Financial Aid / Is It What You Need?,http://mitadmissions.org/blogs/entry/the_history_and_mystery_of_fin_1,3499,0,0,0,0
Nov 12 2004,Matt McGann '00,Visualize whirled peas,http://mitadmissions.org/blogs/entry/visualize_whirled_peas,3499,0,0,0,0
Nov 10 2004,Daniel Barkowitz,Waiting on PINs and PROFILEs,http://mitadmissions.org/blogs/entry/waiting_on_pins_and_profiles,3501,0,0,0,0
Nov 8 2004,Ben Jones,New Portlets?,http://mitadmissions.org/blogs/entry/new_portlets,3503,0,0,0,0
Nov 6 2004,Matt McGann '00,The reading season begins,http://mitadmissions.org/blogs/entry/the_reading_season_begins,3505,0,0,0,0
Nov 3 2004,Matt McGann '00,(Q & A)^n,http://mitadmissions.org/blogs/entry/q_an,3508,0,0,0,0
Nov 2 2004,Matt McGann '00,Refactored,http://mitadmissions.org/blogs/entry/refactored,3509,0,0,0,0
Oct 29 2004,Daniel Barkowitz,Im awaywill return without delay,http://mitadmissions.org/blogs/entry/im_away_will_return_without_de,3513,0,0,0,0
Oct 29 2004,Ben Jones,MyMIT is fixed!,http://mitadmissions.org/blogs/entry/mymit_is_fixed,3513,0,0,0,0
Oct 28 2004,Matt McGann '00,Ups and downs and extras,http://mitadmissions.org/blogs/entry/ups_and_downs_and_extras,3514,0,0,0,0
Oct 27 2004,Daniel Barkowitz,"Data, more Data, and even more Brent Spiner",http://mitadmissions.org/blogs/entry/data_more_data_and_even_more_b,3515,0,0,0,0
Oct 26 2004,Daniel Barkowitz,Can you really go to college for free?,http://mitadmissions.org/blogs/entry/can_you_really_go_to_college_f,3516,1,0,0,1
Oct 25 2004,Matt McGann '00,BoA & Restricting,http://mitadmissions.org/blogs/entry/boa_restricting,3517,0,0,0,0
Oct 25 2004,Ben Jones,Application Reading Season Kickoff,http://mitadmissions.org/blogs/entry/application_reading_season_kic,3517,0,0,0,0
Oct 24 2004,Matt McGann '00,First read,http://mitadmissions.org/blogs/entry/first_read,3518,0,0,0,0
Oct 24 2004,Daniel Barkowitz,Feeling Lost?,http://mitadmissions.org/blogs/entry/feeling_lost,3518,0,0,0,0
Oct 22 2004,Matt McGann '00,A sporting chance,http://mitadmissions.org/blogs/entry/a_sporting_chance,3520,0,0,0,0
Oct 21 2004,Matt McGann '00,Green Monsters,http://mitadmissions.org/blogs/entry/green_monsters,3521,0,0,0,0
Oct 20 2004,Matt McGann '00,The Final Countdown,http://mitadmissions.org/blogs/entry/the_final_countdown,3522,0,0,0,0
Oct 17 2004,Matt McGann '00,Schools of dreams,http://mitadmissions.org/blogs/entry/schools_of_dreams,3525,0,0,0,0
Oct 15 2004,Matt McGann '00,To tell the truth,http://mitadmissions.org/blogs/entry/to_tell_the_truth,3527,0,0,0,0
Oct 9 2004,Matt McGann '00,I like to do the jumble sometimes,http://mitadmissions.org/blogs/entry/i_like_to_do_the_jumble_someti,3533,0,0,0,0
Oct 8 2004,Matt McGann '00,In Stereo,http://mitadmissions.org/blogs/entry/in_stereo,3534,0,0,0,0
Oct 1 2004,Matt McGann '00,Branching out,http://mitadmissions.org/blogs/entry/branching_out,3541,0,0,0,0
Sep 25 2004,Matt McGann '00,I hate the way I dont hate you,http://mitadmissions.org/blogs/entry/i_hate_the_way_i_dont_hate_you,3547,0,0,0,0
Sep 23 2004,Matt McGann '00,camer-AHHHHH! redux,http://mitadmissions.org/blogs/entry/camerahhhhh_redux,3549,0,0,0,0
Sep 23 2004,Mitra L. '07,Classes - Fall 04,http://mitadmissions.org/blogs/entry/classes_fall_04,3549,0,0,0,0
Sep 22 2004,Matt McGann '00,Theory of Actual Reality,http://mitadmissions.org/blogs/entry/theory_of_actual_reality,3550,1,0,0,1
Sep 15 2004,Mitra L. '07,Lewis Music Library,http://mitadmissions.org/blogs/entry/lewis_music_library,3557,0,0,0,0
Sep 7 2004,Matt McGann '00,Keg of worms and phytoplankton,http://mitadmissions.org/blogs/entry/keg_of_worms_and_phytoplankton,3565,0,0,0,0
Sep 1 2004,Matt McGann '00,Love that dirty water,http://mitadmissions.org/blogs/entry/love_that_dirty_water,3571,0,0,0,0
Aug 15 2004,Matt McGann '00,Vive la France!,http://mitadmissions.org/blogs/entry/vive_la_france,3588,0,0,0,0
Aug 12 2004,Matt McGann '00,OReilly Primes?,http://mitadmissions.org/blogs/entry/oreilly_primes,3591,0,0,0,0
Aug 6 2004,Matt McGann '00,"Hello, world",http://mitadmissions.org/blogs/entry/hello_world,3597,1,1,1,3
Aug 6 2004,Ben Jones,All About The Author,http://mitadmissions.org/blogs/entry/all_about_the_author,3597,0,0,0,0
